amountOfVerbs,amountOfPronouns,amountOfNouns,amountOfAdjectives,amountOfAdverbs,restOfWords,totalAmount,id
1,2,6,0,0,4,13,1
0,0,6,0,0,1,7,4
6,0,8,1,0,7,22,5
0,0,5,1,0,2,8,6
3,0,6,0,1,6,16,7
1,0,12,1,0,4,18,8
1,0,10,1,0,2,14,10
1,1,5,0,0,8,15,13
1,0,5,0,1,5,12,14
3,1,3,0,0,3,10,15
2,0,2,0,2,3,9,16
7,3,14,1,0,2,27,17
3,0,5,1,0,3,12,18
1,0,5,0,0,1,7,19
0,0,7,0,0,4,11,20
0,0,2,0,0,1,3,23
1,1,1,0,0,0,3,24
1,0,1,0,1,0,3,25
1,1,1,1,1,0,5,26
0,1,1,0,0,1,3,28
1,0,0,1,0,1,3,31
1,0,2,1,0,0,4,32
0,0,2,0,0,0,2,33
0,1,1,1,0,1,4,34
0,0,1,0,0,0,1,36
2,1,2,0,0,2,7,37
0,0,3,1,0,1,5,38
1,1,1,0,0,0,3,39
0,0,2,0,0,0,2,40
1,1,1,0,0,1,4,41
0,0,1,0,0,1,2,44
1,0,3,1,0,0,5,48
2,1,2,2,1,2,10,49
1,0,6,2,0,1,10,50
2,1,1,1,0,2,7,52
0,0,10,1,0,2,13,53
4,2,7,2,1,5,21,54
0,0,6,0,0,1,7,55
1,0,17,0,0,3,21,56
1,1,2,0,0,1,5,57
1,0,5,0,0,2,8,59
0,0,2,4,0,5,11,61
3,1,11,1,0,7,23,62
0,0,5,0,0,0,5,63
2,3,5,0,1,3,14,64
3,3,4,1,0,5,16,65
4,0,4,0,1,4,13,66
3,0,3,1,0,3,10,67
1,0,5,0,0,2,8,68
3,3,7,4,2,8,27,71
0,0,8,0,0,1,9,73
2,0,6,1,0,2,11,74
1,0,14,0,0,2,17,76
0,0,9,0,0,1,10,77
2,1,6,2,1,3,15,78
2,1,9,1,1,5,19,79
0,0,12,0,0,0,12,80
3,1,9,2,0,9,24,81
6,3,8,2,0,5,24,82
4,0,7,0,1,4,16,83
1,0,10,0,0,6,17,85
3,1,7,1,0,7,19,86
0,0,7,1,0,4,12,89
5,1,7,2,2,5,22,91
1,0,7,0,0,1,9,92
1,0,5,1,0,1,8,93
7,5,2,1,0,4,19,95
6,4,11,1,0,7,29,96
1,1,5,2,0,4,13,97
1,0,12,0,0,4,17,98
5,1,5,1,0,6,18,100
2,0,10,2,0,2,16,102
2,0,11,1,0,4,18,104
0,0,4,0,0,0,4,105
1,1,9,0,0,6,17,107
1,1,6,1,1,2,12,109
3,2,3,0,0,2,10,110
0,0,8,1,1,4,14,112
0,1,9,0,0,8,18,113
2,1,6,0,1,8,18,114
5,3,6,1,2,11,28,117
2,2,6,3,1,5,19,118
5,3,3,1,0,5,17,119
1,0,8,1,2,4,16,120
0,0,7,0,0,5,12,121
3,1,8,1,0,5,18,126
0,0,12,0,0,1,13,128
4,2,12,1,1,6,26,129
3,0,12,1,1,9,26,130
0,0,8,0,0,0,8,131
1,1,2,0,0,1,5,132
0,0,9,0,0,2,11,133
0,0,10,0,0,5,15,134
0,0,7,1,0,1,9,135
0,0,4,0,0,0,4,136
2,1,11,1,0,13,28,137
5,3,8,1,0,5,22,138
4,0,9,2,0,6,21,139
3,3,2,0,0,2,10,141
3,0,9,0,3,6,21,143
4,1,6,1,2,3,17,144
5,1,6,1,3,5,21,145
0,0,3,3,0,2,8,146
4,3,5,2,1,5,20,149
0,0,20,1,0,1,22,151
1,0,7,0,0,4,12,153
0,0,20,1,0,1,22,156
1,1,4,1,0,2,9,157
4,1,7,2,1,9,24,158
0,0,5,1,1,4,11,159
2,0,5,0,0,5,12,160
1,0,3,2,2,3,11,161
3,0,7,4,3,3,20,162
0,0,2,0,0,0,2,163
0,0,20,1,0,1,22,164
0,0,20,1,0,1,22,165
0,0,20,1,0,1,22,168
1,1,4,0,0,2,8,170
0,0,20,1,0,1,22,171
0,0,20,1,0,1,22,172
4,2,5,3,2,4,20,173
2,1,8,1,0,4,16,174
3,2,8,1,1,7,22,175
0,0,11,0,0,1,12,176
2,1,7,2,0,4,16,178
3,1,6,2,3,3,18,180
4,3,5,2,1,10,25,182
4,3,5,1,0,3,16,183
10,3,6,2,0,7,28,184
1,0,6,1,1,2,11,185
2,2,1,0,0,0,5,187
0,0,2,0,0,0,2,190
5,3,4,3,1,5,21,191
7,4,4,2,1,2,20,193
2,0,6,2,0,4,14,194
4,1,13,1,0,1,20,195
4,0,10,2,0,2,18,196
1,0,10,3,0,6,20,197
3,1,3,1,0,6,14,198
3,0,10,2,0,3,18,199
1,1,7,3,0,4,16,201
3,0,10,2,0,4,19,203
1,0,6,0,0,2,9,204
0,0,6,2,0,3,11,205
2,0,12,0,0,8,22,208
0,0,7,2,0,2,11,209
3,0,13,1,0,3,20,210
5,0,10,2,0,3,20,211
1,1,5,4,0,2,13,212
1,2,7,0,1,2,13,213
2,1,6,4,0,9,22,215
3,0,10,2,0,3,18,216
1,0,10,2,1,1,15,218
0,0,7,2,0,3,12,219
0,0,6,2,0,3,11,220
0,0,8,0,1,2,11,221
0,0,15,0,0,3,18,222
0,0,6,0,0,4,10,225
3,0,11,2,0,2,18,226
3,0,10,2,0,3,18,229
1,1,15,3,0,5,25,231
1,1,9,5,1,8,25,232
0,0,8,0,0,2,10,235
4,1,7,1,0,1,14,237
5,0,10,2,0,3,20,238
1,1,1,1,0,1,5,240
2,2,5,1,0,3,13,241
4,1,4,2,1,9,21,242
1,0,7,0,0,4,12,243
0,0,3,1,0,3,7,244
2,0,10,1,0,7,20,245
4,3,7,0,1,9,24,246
2,0,8,0,0,1,11,247
0,0,12,1,0,7,20,248
3,0,8,0,0,1,12,249
3,0,5,1,0,0,9,251
2,0,9,1,3,4,19,252
2,0,7,0,0,1,10,253
0,0,11,0,0,2,13,254
2,0,7,1,0,3,13,256
2,1,7,3,0,4,17,258
4,2,2,1,0,4,13,260
2,0,10,0,0,1,13,261
2,0,8,0,0,1,11,262
1,0,2,0,0,2,5,263
3,1,4,1,0,2,11,264
0,0,11,0,0,2,13,265
0,0,7,0,0,1,8,266
5,4,5,3,0,4,21,267
0,0,16,0,0,4,20,268
2,0,8,0,0,1,11,269
2,0,7,0,0,1,10,270
0,0,11,0,0,2,13,271
1,0,10,0,0,2,13,272
2,3,9,1,1,6,22,273
4,1,4,0,0,4,13,274
3,0,7,0,0,1,11,276
2,0,8,0,0,1,11,277
1,1,3,0,0,4,9,279
1,0,4,2,0,3,10,280
0,0,13,0,0,0,13,281
2,0,8,0,0,1,11,283
2,0,8,0,0,1,11,285
2,0,8,0,0,1,11,287
2,0,8,0,0,1,11,289
0,0,7,0,0,4,11,290
4,2,5,2,1,4,18,291
2,0,8,0,0,1,11,293
4,3,3,0,0,3,13,294
3,1,6,1,1,5,17,296
0,0,18,0,0,1,19,297
1,0,3,0,1,1,6,298
2,2,6,1,0,3,14,299
4,0,6,3,2,4,19,301
1,0,2,0,0,0,3,302
1,0,9,1,0,5,16,303
2,2,6,0,0,5,15,307
6,2,3,1,2,3,17,309
3,1,9,1,0,4,18,310
2,1,0,0,0,1,4,312
3,1,9,1,0,4,18,313
2,1,9,0,2,2,16,314
3,2,2,0,3,3,13,315
4,0,9,0,1,6,20,316
4,2,4,3,0,3,16,318
4,2,5,1,1,9,22,320
3,2,7,3,3,6,24,321
2,0,6,1,0,8,17,322
2,2,4,0,0,6,14,327
2,0,2,1,0,3,8,328
3,1,6,2,0,5,17,329
2,0,4,2,1,0,9,330
4,1,9,0,1,6,21,331
3,0,8,1,1,5,18,332
5,2,4,2,1,9,23,334
2,1,3,2,2,3,13,335
3,2,6,3,2,7,23,336
2,0,10,2,3,5,22,337
3,1,9,1,0,4,18,338
0,0,17,1,0,0,18,340
6,0,13,2,3,5,29,341
2,1,8,1,1,8,21,344
2,0,4,0,0,1,7,345
1,1,9,1,1,4,17,346
5,3,6,2,0,5,21,347
0,0,4,0,0,1,5,348
1,0,15,0,0,4,20,349
1,0,2,0,0,1,4,352
2,0,8,0,0,2,12,353
0,0,7,1,0,2,10,354
1,0,15,0,0,4,20,355
1,0,15,0,0,4,20,356
2,1,6,2,0,5,16,358
1,0,15,0,0,4,20,360
4,0,9,1,0,6,20,361
1,0,5,0,0,0,6,363
2,0,4,1,1,5,13,364
5,2,10,0,0,6,23,365
2,2,4,3,0,3,14,368
1,0,15,0,0,4,20,370
2,1,8,5,1,7,24,371
4,2,10,0,0,6,22,372
5,2,9,0,0,7,23,375
3,0,8,2,0,5,18,380
2,0,6,0,0,4,12,381
5,2,7,1,0,10,25,383
1,0,15,0,0,4,20,384
2,0,5,0,0,2,9,386
0,0,12,1,0,0,13,389
2,0,8,0,0,2,12,390
1,0,15,0,0,4,20,393
1,0,15,0,0,4,20,394
1,1,4,0,3,1,10,396
0,2,11,2,0,1,16,397
1,0,3,0,1,2,7,398
0,0,15,1,0,2,18,401
0,0,2,0,0,0,2,402
0,0,13,1,0,6,20,404
3,2,5,0,0,7,17,406
4,0,8,3,0,5,20,407
0,0,4,1,0,3,8,409
4,3,5,0,0,7,19,410
1,0,8,1,0,2,12,412
1,1,1,0,0,2,5,413
0,0,17,1,0,2,20,415
1,1,3,1,0,5,11,418
1,1,10,3,0,9,24,419
2,0,9,0,1,6,18,420
1,1,16,1,0,4,23,421
1,1,4,1,0,6,13,423
3,1,8,2,1,11,26,424
4,2,4,1,1,4,16,426
2,1,9,1,0,4,17,427
4,3,2,0,2,4,15,429
1,0,7,2,0,7,17,432
0,0,13,1,0,3,17,435
5,1,6,1,1,7,21,436
1,0,9,1,0,3,14,437
3,1,2,0,0,5,11,438
2,0,7,1,0,4,14,440
1,0,2,0,0,1,4,442
1,1,8,2,0,9,21,443
4,1,7,4,0,7,23,444
1,1,12,2,0,3,19,445
0,0,15,1,0,4,20,446
0,0,15,1,0,5,21,447
0,0,11,0,0,3,14,448
0,0,3,1,0,1,5,450
1,0,5,0,1,0,7,451
1,1,6,0,0,3,11,452
0,0,8,2,0,2,12,453
2,1,5,0,1,3,12,454
1,0,15,0,0,1,17,455
1,1,9,2,1,3,17,456
5,4,8,2,0,5,24,457
4,1,8,2,0,8,23,459
1,1,17,0,0,0,19,461
1,0,13,2,0,4,20,462
1,0,15,0,0,1,17,463
0,0,15,1,0,4,20,465
2,1,9,0,0,4,16,466
0,0,2,0,0,0,2,467
2,0,7,2,0,3,14,468
0,0,2,0,0,0,2,469
2,1,9,1,0,10,23,470
3,1,8,0,0,2,14,471
1,0,9,0,0,6,16,472
0,0,14,1,0,5,20,474
3,1,8,0,2,4,18,475
6,1,6,0,0,3,16,476
2,0,14,0,0,2,18,477
2,2,6,1,0,4,15,478
6,0,8,0,2,8,24,479
1,0,6,0,1,1,9,480
1,0,4,0,0,1,6,481
2,1,7,2,1,6,19,482
0,0,4,1,0,0,5,483
2,0,9,1,1,4,17,484
2,0,12,1,0,0,15,485
3,1,3,0,0,1,8,486
2,1,9,4,0,1,17,487
1,0,14,0,0,3,18,489
4,1,15,0,0,2,22,490
3,4,7,2,1,7,24,492
0,0,21,0,0,0,21,493
2,0,7,0,1,1,11,495
1,1,7,0,0,2,11,496
2,1,7,0,0,2,12,498
0,1,9,0,0,3,13,499
0,1,7,0,0,2,10,501
0,1,7,0,0,2,10,502
2,1,7,0,0,2,12,503
4,1,4,1,4,5,19,504
3,2,9,1,0,3,18,506
4,0,12,0,1,5,22,509
1,0,7,1,0,5,14,512
3,2,6,0,0,11,22,513
0,0,7,0,0,3,10,514
2,1,7,0,0,2,12,516
0,0,19,0,0,0,19,517
2,1,7,0,0,2,12,518
0,0,10,0,0,1,11,519
0,0,7,2,0,1,10,520
0,1,10,0,0,3,14,521
1,1,7,0,0,2,11,522
2,1,7,0,0,2,12,523
1,1,8,0,0,1,11,524
2,1,6,0,0,2,11,526
2,1,11,2,1,6,23,527
0,0,16,1,0,2,19,528
1,1,7,0,0,2,11,530
0,1,7,0,0,2,10,531
1,1,7,0,0,2,11,533
0,1,7,0,0,2,10,535
0,0,14,0,1,5,20,536
6,1,5,2,1,7,22,538
0,0,16,1,0,2,19,540
0,0,16,1,0,2,19,542
2,1,7,0,0,2,12,543
2,1,6,0,0,2,11,544
2,0,7,1,0,3,13,546
3,0,7,2,0,3,15,550
4,0,7,0,1,7,19,551
0,0,4,0,0,2,6,552
2,2,5,3,1,2,15,556
4,0,8,0,0,3,15,558
3,0,11,1,0,3,18,559
3,0,11,1,0,3,18,560
0,0,2,0,0,2,4,561
0,0,11,0,0,2,13,563
1,1,2,0,0,0,4,564
2,0,6,0,0,3,11,565
0,0,7,1,0,2,10,567
1,0,4,3,0,5,13,568
0,0,8,1,0,0,9,569
0,0,12,2,0,5,19,570
1,0,4,1,0,2,8,571
3,0,15,1,0,5,24,574
3,0,8,1,0,3,15,575
4,0,6,2,0,6,18,576
0,0,10,0,0,3,13,577
0,0,2,1,0,1,4,578
0,0,12,2,0,5,19,579
3,0,11,1,0,3,18,580
0,0,12,0,0,3,15,581
0,0,11,0,0,2,13,583
3,0,11,1,0,3,18,584
0,0,9,0,0,2,11,585
2,0,7,0,0,4,13,588
2,0,9,3,0,2,16,589
2,0,9,0,0,3,14,592
2,0,6,0,0,3,11,594
2,0,3,2,0,0,7,598
0,0,5,1,1,0,7,599
1,0,5,1,0,0,7,600
1,0,5,3,2,5,16,603
2,0,3,1,0,1,7,604
2,0,6,0,0,3,11,606
1,0,3,2,0,1,7,607
0,0,2,1,0,1,4,608
1,0,9,0,1,2,13,609
0,0,4,0,0,1,5,611
4,3,2,1,0,4,14,612
2,0,9,3,0,0,14,613
3,0,9,3,0,1,16,614
1,1,14,1,0,0,17,615
3,1,2,1,0,2,9,617
2,0,7,1,0,2,12,619
1,1,1,0,0,1,4,621
2,0,8,0,1,3,14,622
3,0,10,0,0,5,18,623
2,0,1,0,1,2,6,624
2,0,11,0,0,1,14,625
0,0,2,0,0,0,2,628
1,0,6,1,0,0,8,630
2,0,4,2,1,1,10,631
4,2,3,1,1,4,15,633
0,0,9,0,0,1,10,635
2,1,6,3,0,6,18,636
1,0,3,1,0,0,5,637
1,0,5,3,1,2,12,638
1,0,5,0,0,2,8,640
1,1,1,3,0,2,8,641
2,0,11,1,0,6,20,642
5,0,6,0,0,6,17,643
1,0,9,1,0,4,15,644
1,0,7,2,0,1,11,646
2,1,4,1,0,4,12,649
0,0,14,0,1,0,15,651
0,0,6,0,0,1,7,652
2,0,5,0,1,2,10,653
4,3,4,2,2,5,20,654
2,0,6,1,1,4,14,655
3,1,3,1,0,8,16,656
0,0,8,0,0,3,11,657
2,0,9,1,0,2,14,658
2,0,8,1,0,2,13,659
2,0,4,2,0,1,9,660
1,0,11,0,0,3,15,661
1,0,10,0,0,2,13,662
1,0,9,1,0,3,14,664
1,0,11,1,0,1,14,665
1,0,7,2,0,1,11,667
5,2,6,1,1,2,17,669
2,1,4,3,1,1,12,671
8,1,7,1,2,9,28,672
0,0,9,0,0,1,10,674
0,0,11,2,2,3,18,675
3,0,7,3,0,1,14,677
0,0,3,2,0,2,7,679
2,0,5,3,0,1,11,680
3,0,8,2,1,7,21,681
2,0,15,1,0,5,23,682
2,1,8,2,2,5,20,683
0,0,14,0,1,0,15,684
4,0,8,2,0,13,27,685
4,2,8,1,2,7,24,686
0,1,6,0,0,1,8,687
2,2,4,2,0,3,13,688
0,0,8,0,0,4,12,689
1,0,16,1,1,0,19,690
0,0,2,0,0,0,2,691
1,3,3,0,0,1,8,697
3,0,11,1,0,3,18,699
7,4,5,1,0,5,22,700
1,1,1,1,0,0,4,702
1,0,2,1,1,0,5,704
6,1,6,2,3,2,20,705
9,1,7,1,0,6,24,706
2,0,5,1,1,3,12,709
2,0,7,2,0,5,16,710
2,0,7,2,0,5,16,712
2,0,7,2,0,5,16,713
4,0,7,1,0,5,17,714
1,0,3,0,0,3,7,716
2,0,7,2,0,5,16,717
1,0,6,1,0,4,12,719
1,0,3,0,0,0,4,720
1,2,15,0,1,3,22,721
2,0,7,2,0,5,16,724
2,0,7,2,0,5,16,725
5,3,6,3,0,4,21,726
1,0,9,0,0,4,14,727
7,2,2,0,1,3,15,728
2,0,7,2,0,5,16,729
2,0,7,2,0,5,16,730
2,0,7,2,0,5,16,731
2,1,7,2,0,5,17,732
2,0,7,2,0,5,16,734
3,2,2,1,2,2,12,735
2,0,7,2,0,5,16,736
2,0,7,2,0,5,16,737
2,0,7,2,0,5,16,738
6,2,11,1,0,5,25,739
2,0,7,2,0,5,16,740
2,2,2,1,0,2,9,744
2,0,7,2,0,5,16,745
1,1,9,1,0,1,13,746
1,1,7,1,0,2,12,748
1,0,2,0,0,3,6,751
0,0,15,0,0,1,16,752
0,0,14,0,0,3,17,753
1,2,6,1,0,0,10,754
3,4,6,2,1,5,21,755
0,0,13,1,0,1,15,758
1,0,9,2,0,4,16,759
2,0,8,1,0,4,15,761
0,0,9,1,0,2,12,762
1,0,9,1,0,5,16,763
2,0,6,0,1,9,18,767
3,1,7,4,1,2,18,770
0,0,16,1,0,1,18,773
1,0,14,2,0,3,20,774
4,1,4,0,0,6,15,775
1,0,10,2,0,2,15,777
3,0,6,0,0,1,10,779
0,0,17,0,0,4,21,781
1,0,10,0,0,6,17,782
3,0,8,1,0,6,18,783
3,1,6,1,0,0,11,784
0,0,3,2,1,0,6,786
1,2,6,1,1,3,14,787
0,0,4,3,0,3,10,788
1,1,8,1,0,5,16,790
1,0,6,0,0,0,7,791
1,0,16,1,0,5,23,794
1,0,2,1,1,3,8,795
0,0,13,1,0,3,17,796
0,0,14,0,0,1,15,797
2,0,7,0,0,3,12,798
1,1,11,2,0,4,19,799
0,0,13,0,0,1,14,800
2,3,3,1,2,4,15,801
2,3,9,1,0,6,21,802
2,1,6,0,0,3,12,803
1,0,10,3,0,7,21,804
3,0,9,0,0,7,19,805
2,1,9,1,1,7,21,806
0,0,8,0,0,0,8,807
2,1,4,0,1,3,11,808
2,2,2,1,0,3,10,809
1,1,7,1,0,2,12,810
2,1,7,0,1,2,13,812
2,0,5,3,0,8,18,814
1,1,7,1,0,1,11,815
0,0,1,3,0,0,4,817
1,1,10,1,2,7,22,818
2,1,1,1,1,3,9,819
0,0,3,0,0,2,5,820
0,0,13,1,0,3,17,822
3,0,9,0,0,7,19,823
1,0,9,0,1,3,14,826
3,2,7,3,0,5,20,828
2,0,8,0,2,3,15,829
2,0,4,0,1,3,10,832
3,0,5,1,2,3,14,833
2,0,8,0,2,4,16,834
3,0,5,1,0,0,9,835
2,0,7,0,2,3,14,836
2,0,8,1,2,3,16,837
2,1,11,1,2,4,21,838
5,0,8,1,0,2,16,840
2,0,3,2,1,3,11,841
3,0,9,2,0,2,16,842
2,0,8,0,2,4,16,843
1,0,16,0,0,5,22,845
2,0,9,2,1,4,18,846
2,0,8,0,2,3,15,848
3,0,9,0,2,4,18,849
2,0,13,0,2,4,21,851
2,0,6,2,2,6,18,852
2,0,8,0,2,3,15,853
2,0,7,0,2,3,14,856
3,0,7,2,3,3,18,857
2,0,6,1,1,2,12,859
2,1,5,1,1,5,15,860
3,0,9,0,0,6,18,863
2,0,4,0,1,3,10,864
3,0,7,2,0,0,12,866
3,0,11,2,0,3,19,867
2,0,8,2,2,2,16,868
2,0,8,0,2,4,16,870
4,0,3,1,0,0,8,871
2,0,7,0,2,3,14,872
2,0,7,0,2,3,14,873
1,0,7,0,2,0,10,874
2,0,7,0,2,3,14,875
3,0,11,2,0,3,19,876
2,0,8,0,2,4,16,877
4,0,9,1,0,3,17,878
1,0,2,0,0,1,4,881
1,1,12,1,0,3,18,882
1,0,12,0,0,3,16,883
0,0,13,2,0,6,21,884
4,2,18,0,1,8,33,885
4,2,6,3,0,5,20,886
1,0,6,1,0,3,11,888
1,0,12,1,0,0,14,890
1,1,14,2,0,3,21,891
0,1,12,0,0,2,15,892
2,0,11,4,0,5,22,893
4,1,6,1,3,6,21,894
4,0,7,0,0,3,14,895
3,0,7,3,1,8,22,896
1,0,2,0,0,1,4,898
1,0,4,1,1,4,11,899
3,0,8,1,0,3,15,902
3,0,10,1,0,2,16,903
3,0,10,1,2,6,22,905
4,2,5,4,1,5,21,906
1,0,2,0,0,1,4,907
2,0,9,0,0,6,17,911
1,3,12,2,1,4,23,912
4,2,17,0,1,8,32,915
1,0,2,0,0,1,4,916
4,2,17,0,1,8,32,919
1,0,11,2,0,6,20,921
5,2,5,3,1,4,20,923
0,0,7,0,0,2,9,926
0,0,11,1,1,2,15,928
1,0,1,1,0,0,3,929
1,0,4,0,0,3,8,930
4,1,6,0,0,3,14,931
6,5,8,3,1,3,26,932
1,1,3,0,0,0,5,934
1,2,0,1,0,1,5,935
2,1,10,1,0,7,21,936
2,0,8,0,2,2,14,938
0,0,9,1,1,0,11,939
1,3,4,1,0,6,15,940
1,1,3,1,0,2,8,941
2,0,5,0,0,1,8,942
4,1,5,0,1,6,17,944
2,0,5,1,2,2,12,945
2,0,6,1,0,1,10,946
0,0,2,0,1,0,3,947
4,1,7,0,0,6,18,948
1,1,13,1,0,2,18,951
4,1,7,2,0,3,17,952
1,1,4,0,2,2,10,953
0,0,12,1,0,0,13,955
3,3,7,1,0,9,23,956
1,0,5,0,1,4,11,957
2,1,1,0,1,0,5,958
1,2,4,1,0,3,11,959
5,2,5,3,1,4,20,960
2,0,9,1,0,2,14,961
1,0,3,1,0,5,10,962
1,1,7,1,0,2,12,963
1,0,9,1,2,3,16,964
1,1,7,1,2,4,16,965
1,1,4,2,3,3,14,968
4,1,3,1,1,2,12,971
3,3,6,1,2,6,21,972
0,0,8,1,0,5,14,974
2,1,1,0,0,2,6,976
0,0,6,0,0,0,6,977
3,0,8,1,0,3,15,978
0,0,7,0,0,1,8,979
2,0,5,2,0,1,10,981
1,0,8,1,0,6,16,982
4,1,7,0,0,8,20,983
0,0,22,0,0,1,23,984
0,0,22,0,0,1,23,985
4,1,3,1,2,2,13,986
2,0,7,3,1,5,18,987
0,0,8,2,0,1,11,990
4,3,7,1,0,5,20,991
1,1,3,0,0,2,7,992
2,0,6,1,1,2,12,993
3,1,4,1,3,3,15,994
0,0,14,0,0,0,14,996
3,0,11,1,0,6,21,997
2,2,7,0,0,4,15,998
0,0,3,1,0,1,5,999
4,2,7,5,0,5,23,1001
2,0,12,0,0,8,22,1002
1,0,9,3,2,8,23,1004
3,2,4,0,0,3,12,1005
1,0,0,0,1,0,2,1006
4,3,4,1,0,6,18,1008
2,2,1,0,0,1,6,1009
8,2,8,1,0,7,26,1010
2,1,11,1,0,0,15,1015
3,2,4,2,0,3,14,1017
1,0,1,1,1,1,5,1018
0,0,9,0,0,2,11,1020
0,0,22,0,0,2,24,1021
4,0,11,0,1,6,22,1022
4,1,10,1,1,5,22,1023
1,2,7,0,0,4,14,1024
3,1,5,1,1,6,17,1026
1,0,4,1,1,2,9,1029
3,1,3,0,2,3,12,1031
3,3,2,0,0,4,12,1032
4,1,5,1,1,2,14,1035
3,1,2,1,2,4,13,1036
5,1,5,0,2,7,20,1037
8,5,6,1,1,4,25,1038
3,3,2,0,1,6,15,1040
3,1,3,3,3,2,15,1041
4,3,5,0,2,1,15,1042
5,0,1,1,3,6,16,1043
1,0,3,0,0,3,7,1044
3,2,3,0,1,0,9,1045
2,1,2,2,2,1,10,1048
6,3,6,2,1,6,24,1049
2,1,2,0,0,0,5,1050
4,2,3,0,0,3,12,1051
1,0,7,1,1,1,11,1052
2,0,2,0,1,2,7,1054
3,3,3,0,1,2,12,1057
4,3,5,2,1,3,18,1058
1,0,4,1,0,1,7,1061
6,3,6,4,1,8,28,1062
3,2,1,0,0,2,8,1065
3,2,4,1,0,3,13,1066
3,2,1,2,1,0,9,1067
1,0,4,1,0,3,9,1069
3,1,4,2,0,4,14,1070
2,0,6,2,1,5,16,1071
6,4,5,0,1,4,20,1072
3,1,2,1,0,0,7,1073
2,1,1,0,1,0,5,1074
3,0,5,1,1,2,12,1075
4,2,3,0,0,2,11,1077
3,1,6,2,0,4,16,1078
1,1,2,1,2,1,8,1079
2,1,3,2,1,1,10,1080
3,1,3,3,0,3,13,1081
2,1,3,0,0,4,10,1082
5,4,3,2,2,4,20,1083
2,1,4,3,3,5,18,1084
6,2,8,2,1,8,27,1085
8,5,4,2,1,6,26,1088
5,5,3,1,2,3,19,1090
7,4,6,3,0,6,26,1091
3,0,5,1,3,5,17,1093
3,0,3,0,0,1,7,1094
1,1,4,0,0,1,7,1098
3,1,4,1,2,4,15,1099
4,3,7,0,1,7,22,1102
1,0,2,0,1,2,6,1103
1,1,1,0,1,3,7,1104
4,0,10,1,3,3,21,1105
4,2,10,3,1,7,27,1106
2,2,1,1,0,2,8,1109
5,3,6,0,1,10,25,1110
0,0,2,0,0,2,4,1112
5,3,4,0,0,5,17,1113
1,0,1,0,1,2,5,1114
0,0,5,0,0,0,5,1117
2,0,5,2,0,5,14,1118
4,1,5,0,1,9,20,1119
3,3,8,0,0,5,19,1120
4,0,4,1,2,4,15,1122
2,1,3,2,1,4,13,1123
1,0,2,0,1,1,5,1124
1,1,3,0,0,1,6,1126
5,3,5,1,2,7,23,1128
2,1,4,2,0,5,14,1129
2,0,7,1,2,11,23,1130
6,1,9,1,1,7,25,1132
0,0,3,0,0,0,3,1134
0,0,2,0,0,0,2,1136
6,4,7,3,2,6,28,1138
2,0,6,0,0,5,13,1139
0,0,8,1,0,2,11,1141
1,0,9,0,0,1,11,1142
3,0,4,0,2,3,12,1143
1,2,13,1,0,5,22,1145
0,0,9,0,0,1,10,1146
2,0,11,1,0,3,17,1149
3,0,2,3,0,2,10,1151
1,0,9,1,0,5,16,1152
1,0,9,0,0,2,12,1153
5,2,6,2,0,8,23,1154
2,0,2,2,0,4,10,1155
1,2,3,0,0,1,7,1156
0,0,5,0,0,0,5,1157
3,2,2,2,3,2,14,1160
1,0,8,1,0,3,13,1162
3,2,14,0,0,2,21,1164
3,1,2,1,0,2,9,1166
4,2,7,0,2,11,26,1167
1,1,11,1,1,4,19,1168
6,1,5,0,2,12,26,1170
4,0,7,2,1,10,24,1173
4,1,5,1,0,8,19,1174
1,0,10,1,1,7,20,1175
2,0,3,1,1,0,7,1177
1,1,1,1,0,0,4,1178
2,2,8,4,1,8,25,1179
1,0,4,0,0,1,6,1181
1,0,8,1,0,3,13,1182
1,0,4,0,1,0,6,1183
5,4,9,1,2,2,23,1185
2,1,11,2,0,5,21,1188
3,2,4,1,2,4,16,1189
4,2,8,2,0,8,24,1190
1,0,1,0,0,0,2,1191
3,1,7,1,0,4,16,1195
4,0,7,0,1,5,17,1196
1,0,1,0,0,0,2,1198
1,0,4,0,0,1,6,1199
2,1,1,2,0,2,8,1201
0,0,4,0,0,0,4,1202
2,1,3,0,1,3,10,1203
0,0,9,0,0,1,10,1204
4,2,3,2,7,4,22,1206
1,0,5,1,0,3,10,1207
0,0,5,0,0,2,7,1208
1,1,1,1,0,1,5,1209
1,2,4,1,0,0,8,1211
2,0,2,0,0,2,6,1212
1,2,3,0,3,3,12,1213
1,0,8,2,0,2,13,1214
1,1,2,0,0,0,4,1215
0,0,6,1,0,1,8,1217
1,1,3,0,0,1,6,1218
1,1,2,0,2,0,6,1219
1,1,2,1,1,0,6,1221
1,3,2,1,0,2,9,1222
0,0,9,0,0,0,9,1223
1,0,6,1,0,0,8,1224
2,2,3,1,0,2,10,1225
2,2,4,1,0,3,12,1226
3,2,10,2,0,10,27,1227
2,0,2,1,0,0,5,1228
0,0,2,0,0,0,2,1229
2,0,6,2,1,1,12,1230
0,0,8,0,0,5,13,1232
7,4,6,1,1,6,25,1234
1,0,9,0,0,9,19,1235
3,1,11,1,0,3,19,1236
5,4,2,0,2,6,19,1237
3,3,1,0,0,1,8,1238
3,0,5,2,4,6,20,1239
3,2,4,2,0,3,14,1240
3,3,6,6,1,5,24,1241
1,0,11,1,0,1,14,1242
3,2,4,1,0,4,14,1243
1,1,3,0,0,0,5,1244
3,1,9,3,0,2,18,1245
2,2,5,0,1,3,13,1249
4,2,6,2,0,4,18,1250
2,0,6,2,1,3,14,1251
0,0,3,2,0,0,5,1252
1,1,1,0,0,3,6,1253
2,1,3,1,0,4,11,1254
0,1,3,0,0,2,6,1259
6,0,6,1,0,4,17,1262
0,0,6,3,1,0,10,1263
1,1,5,0,0,4,11,1264
0,0,2,1,0,0,3,1267
0,0,6,1,0,0,7,1269
0,1,10,0,0,1,12,1270
1,1,9,3,0,4,18,1271
1,0,2,0,0,2,5,1272
2,1,4,3,1,2,13,1273
4,1,8,1,0,7,21,1275
2,0,4,1,0,1,8,1276
2,2,5,2,1,5,17,1277
3,2,7,2,0,8,22,1278
1,1,4,0,0,2,8,1279
3,0,1,2,1,0,7,1280
1,0,1,2,1,0,5,1282
4,1,7,0,1,4,17,1283
3,2,9,0,0,0,14,1284
1,0,4,0,1,2,8,1287
1,1,6,2,2,4,16,1288
2,0,6,0,0,2,10,1289
5,1,14,2,0,3,25,1290
2,0,4,2,1,2,11,1293
5,0,8,2,0,8,23,1294
0,0,4,0,1,0,5,1296
2,0,10,3,0,3,18,1297
2,2,5,0,1,8,18,1298
4,6,6,3,0,2,21,1300
5,3,9,1,4,4,26,1301
0,0,2,1,0,0,3,1302
1,0,4,2,0,0,7,1303
4,2,9,3,2,9,29,1304
3,0,9,1,0,4,17,1305
4,1,7,1,0,7,20,1307
3,5,7,1,1,9,26,1308
2,2,3,1,2,0,10,1309
5,3,9,2,1,4,24,1312
0,0,4,1,0,0,5,1315
0,0,6,0,0,2,8,1316
4,2,7,1,1,6,21,1317
0,0,4,0,0,1,5,1318
3,0,4,3,0,4,14,1319
5,4,5,1,2,2,19,1320
2,2,6,1,2,3,16,1321
5,2,6,1,0,6,20,1324
1,0,7,2,1,1,12,1326
0,0,14,1,0,2,17,1327
3,0,5,0,1,1,10,1328
5,2,9,0,1,5,22,1331
6,3,6,1,0,7,23,1332
5,0,7,1,2,9,24,1334
2,0,3,1,0,3,9,1335
0,0,2,1,1,1,5,1337
1,0,4,0,0,1,6,1338
0,0,21,0,0,1,22,1340
3,0,8,2,1,3,17,1341
2,0,2,0,3,2,9,1343
2,2,2,0,0,3,9,1345
2,0,5,2,0,6,15,1346
6,0,6,1,1,12,26,1347
4,1,6,1,1,5,18,1348
4,1,8,1,0,8,22,1349
2,0,12,0,0,3,17,1350
4,4,5,1,1,4,19,1351
3,0,5,1,2,6,17,1352
5,2,4,4,2,6,23,1353
7,2,4,0,2,6,21,1354
4,0,9,0,1,8,22,1356
7,4,2,2,4,6,25,1360
5,0,5,1,1,5,17,1361
5,1,3,2,0,3,14,1362
2,1,9,3,0,5,20,1363
6,3,4,0,1,3,17,1365
5,1,10,0,0,7,23,1368
8,0,4,3,4,9,28,1369
0,0,2,0,3,1,6,1371
1,2,9,0,1,1,14,1372
2,0,2,0,0,4,8,1374
7,4,6,1,1,9,28,1375
3,0,3,1,3,1,11,1376
4,0,7,0,1,8,20,1378
0,0,19,0,0,0,19,1379
0,0,19,0,0,0,19,1380
7,3,7,0,1,13,31,1381
6,4,4,3,0,8,25,1382
1,0,18,0,0,1,20,1383
0,0,14,1,0,1,16,1384
0,0,14,1,0,1,16,1385
0,0,11,0,0,0,11,1388
1,0,14,0,0,1,16,1389
1,0,9,3,0,7,20,1390
0,0,19,0,0,0,19,1391
0,0,10,2,1,0,13,1393
2,0,17,1,0,1,21,1394
6,4,7,1,1,9,28,1395
1,0,18,0,0,0,19,1396
0,0,16,1,0,2,19,1399
1,0,13,0,0,1,15,1401
1,0,14,0,0,0,15,1402
0,0,10,2,1,0,13,1405
2,0,15,2,0,1,20,1406
0,0,14,1,0,1,16,1407
0,0,19,0,0,0,19,1408
1,0,14,0,0,0,15,1409
3,1,4,0,0,5,13,1411
1,0,14,1,0,0,16,1412
1,0,14,0,1,0,16,1414
1,0,13,2,0,2,18,1415
1,0,16,2,0,2,21,1418
0,0,14,1,0,1,16,1419
1,0,14,0,0,0,15,1420
0,1,7,0,0,3,11,1421
1,0,18,0,0,0,19,1422
3,2,9,1,2,6,23,1425
7,2,4,1,1,6,21,1429
3,2,3,2,0,0,10,1431
2,0,2,1,1,0,6,1432
3,0,6,1,0,5,15,1433
4,2,12,1,0,1,20,1436
5,4,7,3,0,8,27,1439
2,0,2,0,0,0,4,1440
2,1,4,1,0,3,11,1441
0,1,6,1,1,0,9,1443
1,0,4,0,0,0,5,1444
1,0,3,0,0,0,4,1445
4,2,7,1,2,7,23,1447
2,0,7,1,0,4,14,1448
2,2,5,0,0,4,13,1449
5,2,4,2,2,3,18,1450
2,0,6,1,0,2,11,1452
2,2,7,1,1,2,15,1453
4,2,6,2,2,5,21,1454
4,2,3,1,2,1,13,1455
1,0,7,0,0,2,10,1456
5,3,7,1,1,5,22,1458
4,3,8,1,0,7,23,1459
4,3,11,4,1,2,25,1460
4,1,10,3,2,8,28,1463
3,0,9,4,0,5,21,1464
3,0,8,1,0,0,12,1466
5,2,4,2,2,5,20,1467
5,0,10,2,1,4,22,1470
6,4,1,0,0,2,13,1472
2,0,8,2,0,1,13,1473
0,0,2,1,2,1,6,1474
2,0,4,0,0,3,9,1475
1,2,4,1,2,1,11,1477
5,1,6,1,0,4,17,1479
0,0,16,0,0,3,19,1480
0,0,10,0,0,1,11,1482
0,0,14,0,0,1,15,1483
0,0,12,0,0,0,12,1484
1,0,4,0,0,4,9,1485
0,0,11,0,0,1,12,1486
2,0,7,1,1,3,14,1487
1,0,12,1,0,8,22,1488
0,0,3,0,0,0,3,1491
3,4,9,0,0,10,26,1493
4,0,12,0,0,6,22,1494
0,0,12,0,0,0,12,1495
3,0,11,1,0,8,23,1497
1,0,13,0,0,0,14,1498
0,0,13,0,0,0,13,1499
2,0,3,0,0,1,6,1500
0,0,14,0,0,1,15,1501
3,0,10,1,0,5,19,1502
2,2,7,3,0,8,22,1503
0,0,3,0,0,0,3,1504
3,0,8,2,3,1,17,1505
2,1,14,2,0,1,20,1506
0,0,14,0,0,0,14,1507
0,0,14,0,0,0,14,1508
0,0,4,1,0,2,7,1509
2,1,4,2,0,2,11,1510
0,0,13,0,0,0,13,1511
6,3,11,1,0,5,26,1513
1,0,6,2,1,4,14,1514
2,0,5,0,0,2,9,1515
2,1,4,0,0,1,8,1518
5,4,5,3,3,5,25,1519
0,0,17,0,0,0,17,1520
2,0,12,3,0,0,17,1521
0,0,13,0,0,0,13,1522
2,0,3,1,0,0,6,1523
2,1,10,1,2,2,18,1524
0,0,12,0,0,1,13,1525
5,0,13,0,0,5,23,1526
0,0,15,0,0,0,15,1527
1,2,8,3,0,6,20,1530
0,0,10,2,0,1,13,1531
1,0,10,1,0,8,20,1532
2,0,5,0,0,4,11,1533
3,0,4,0,0,3,10,1534
2,0,9,1,1,9,22,1535
0,0,5,1,0,0,6,1537
0,0,7,0,0,0,7,1538
3,3,4,2,1,2,15,1540
2,0,4,0,1,2,9,1543
1,0,6,1,0,3,11,1544
2,0,8,0,0,1,11,1545
1,1,3,1,0,0,6,1546
4,3,5,2,0,2,16,1547
3,2,4,0,0,5,14,1549
2,0,3,2,1,1,9,1553
2,0,8,0,0,1,11,1554
1,0,4,0,0,2,7,1555
5,1,8,2,0,6,22,1556
0,0,4,1,0,0,5,1558
1,1,4,0,0,2,8,1559
5,2,5,4,3,3,22,1560
5,5,7,0,0,12,29,1561
1,0,4,1,0,3,9,1562
1,0,3,1,0,1,6,1567
0,0,3,1,0,2,6,1568
3,2,9,0,0,7,21,1569
0,0,3,1,3,0,7,1570
3,1,5,2,1,3,15,1572
1,0,6,1,0,2,10,1573
1,0,9,0,0,6,16,1574
2,0,9,1,1,9,22,1575
2,1,11,4,1,5,24,1576
1,0,3,1,0,0,5,1577
3,0,11,0,3,6,23,1579
1,1,3,0,0,0,5,1580
4,0,9,1,2,5,21,1582
3,0,9,0,1,6,19,1585
0,0,7,1,0,2,10,1587
3,1,3,0,0,1,8,1588
4,0,12,0,0,6,22,1590
1,0,3,0,0,3,7,1591
4,0,6,1,3,8,22,1593
3,0,10,0,2,7,22,1594
3,0,7,1,0,8,19,1595
2,0,12,2,1,11,28,1596
1,0,2,0,0,0,3,1597
3,0,7,3,0,9,22,1599
0,0,5,2,0,9,16,1600
5,4,5,1,0,6,21,1601
2,0,1,1,0,0,4,1602
0,0,5,0,0,3,8,1603
2,0,12,0,0,0,14,1604
5,1,5,0,1,6,18,1605
0,0,7,1,0,1,9,1607
4,2,9,1,2,6,24,1608
3,0,9,3,2,3,20,1609
3,0,5,2,1,4,15,1610
5,1,4,0,1,5,16,1611
2,1,4,2,0,0,9,1613
3,0,7,0,1,5,16,1614
5,1,7,1,2,5,21,1615
0,0,6,0,0,3,9,1617
7,4,5,0,0,9,25,1618
1,1,7,1,0,1,11,1619
5,1,10,0,0,9,25,1621
2,1,4,0,1,0,8,1622
2,2,4,2,1,3,14,1623
1,0,7,0,1,4,13,1625
3,2,8,3,1,8,25,1626
0,1,3,1,1,1,7,1627
1,0,3,0,0,0,4,1628
2,0,8,0,0,3,13,1631
3,0,7,0,0,8,18,1632
2,0,5,1,0,4,12,1633
2,0,9,3,2,8,24,1634
4,1,7,1,0,9,22,1636
2,0,10,0,0,7,19,1637
5,0,5,5,1,4,20,1638
2,0,6,1,0,4,13,1639
2,0,9,1,0,4,16,1643
1,0,9,2,0,2,14,1644
1,0,4,1,2,2,10,1645
2,0,5,1,0,4,12,1646
1,0,4,2,0,1,8,1647
0,0,8,0,0,1,9,1648
0,0,8,0,0,1,9,1649
0,0,8,0,0,1,9,1650
0,0,8,0,0,1,9,1652
1,0,12,3,0,10,26,1653
1,0,7,1,1,0,10,1654
1,0,8,1,0,4,14,1657
1,0,5,1,0,2,9,1658
1,0,6,1,0,3,11,1660
2,0,10,3,1,4,20,1661
2,2,3,1,0,4,12,1662
3,1,2,1,0,1,8,1663
2,0,9,3,2,8,24,1665
2,1,3,1,0,4,11,1666
3,0,11,1,0,6,21,1669
1,0,6,1,0,2,10,1670
2,0,8,0,0,6,16,1671
1,0,9,3,2,3,18,1672
1,0,8,0,0,3,12,1673
0,0,16,0,0,1,17,1675
1,0,11,1,0,7,20,1676
1,0,4,2,0,4,11,1677
1,1,10,1,1,4,18,1679
2,2,7,0,1,10,22,1683
0,0,9,1,0,0,10,1684
1,0,9,1,1,1,13,1686
2,0,4,2,0,3,11,1687
1,0,9,0,0,3,13,1688
1,0,12,1,0,3,17,1689
2,0,4,2,0,3,11,1690
5,2,7,0,0,12,26,1691
1,0,7,2,0,4,14,1692
2,0,5,2,0,4,13,1693
3,1,6,3,1,6,20,1694
3,2,9,1,1,6,22,1698
2,0,4,2,0,3,11,1699
2,0,4,2,0,3,11,1700
2,0,7,2,0,3,14,1701
1,0,8,0,0,3,12,1702
4,0,10,1,2,6,23,1703
2,0,4,2,0,3,11,1705
2,0,4,2,0,3,11,1706
1,0,11,1,0,7,20,1707
1,0,8,0,0,3,12,1709
0,0,7,0,0,1,8,1710
2,0,10,1,0,10,23,1712
1,0,12,0,0,3,16,1715
2,0,4,2,0,3,11,1716
5,3,5,1,3,3,20,1718
2,0,8,0,0,6,16,1719
6,2,7,0,2,5,22,1720
1,0,2,1,1,7,12,1721
2,0,8,1,0,4,15,1722
2,0,8,0,0,1,11,1723
5,2,6,1,0,3,17,1724
5,1,7,0,1,7,21,1725
1,0,8,1,0,1,11,1726
2,1,4,1,0,2,10,1727
2,1,7,0,2,8,20,1728
3,1,12,5,2,4,27,1731
2,1,7,1,2,3,16,1733
3,0,7,3,1,7,21,1735
2,0,3,1,0,0,6,1737
7,1,6,0,1,2,17,1739
4,1,7,2,1,8,23,1740
4,0,3,1,0,3,11,1741
4,5,4,1,4,4,22,1744
1,0,1,1,0,2,5,1745
4,1,4,1,1,2,13,1747
2,0,7,2,3,4,18,1750
1,1,9,0,0,5,16,1752
3,0,8,2,0,5,18,1753
3,1,5,2,1,4,16,1754
4,4,5,2,1,3,19,1755
3,1,7,1,0,4,16,1756
3,1,4,0,0,3,11,1757
4,3,4,1,0,3,15,1759
2,1,9,3,1,7,23,1760
1,0,4,0,0,0,5,1761
3,0,4,1,0,1,9,1762
3,0,6,0,0,5,14,1763
4,1,9,2,0,6,22,1766
3,1,3,1,0,2,10,1767
2,0,10,0,0,5,17,1768
4,1,11,3,1,2,22,1769
0,0,13,1,0,5,19,1770
1,0,7,2,0,4,14,1771
2,0,8,1,0,6,17,1772
1,0,7,2,0,4,14,1773
1,0,8,0,0,4,13,1774
1,0,5,0,0,4,10,1775
0,0,6,1,0,2,9,1776
2,1,6,0,0,4,13,1779
1,0,10,2,0,10,23,1780
5,1,5,4,2,2,19,1784
2,1,9,0,1,6,19,1786
2,1,6,1,0,5,15,1787
2,1,7,4,0,4,18,1789
1,0,3,0,0,3,7,1790
4,0,7,1,1,6,19,1791
5,3,6,0,1,6,21,1792
3,1,11,0,1,7,23,1796
2,1,10,0,0,7,20,1798
1,0,9,2,0,3,15,1799
2,0,13,1,0,6,22,1802
4,2,8,2,1,2,19,1803
3,1,8,0,1,3,16,1804
1,0,3,0,0,3,7,1807
1,0,9,0,1,4,15,1808
4,1,7,1,0,7,20,1809
1,0,10,0,0,8,19,1810
4,0,8,3,2,4,21,1811
2,1,4,0,1,4,12,1812
6,2,5,1,0,6,20,1813
4,0,9,0,0,7,20,1814
1,0,9,2,0,4,16,1815
3,0,12,1,0,5,21,1816
2,0,10,0,0,7,19,1817
2,1,11,1,1,3,19,1818
1,2,22,0,0,0,25,1821
4,0,7,0,0,3,14,1822
3,2,2,3,3,3,16,1823
6,6,6,1,1,4,24,1824
5,1,12,1,3,5,27,1826
1,1,1,0,0,0,3,1827
3,0,2,0,1,0,6,1831
5,2,5,1,0,8,21,1832
4,2,8,0,1,7,22,1833
3,2,7,2,3,8,25,1834
4,1,7,2,3,7,24,1835
9,2,6,2,0,7,26,1836
4,1,3,0,0,3,11,1837
3,1,5,2,1,5,17,1838
3,0,5,1,0,4,13,1840
2,0,2,1,1,2,8,1841
3,0,2,4,0,1,10,1842
3,3,5,0,0,4,15,1845
4,1,3,0,0,2,10,1847
3,0,3,1,2,0,9,1848
6,1,5,4,2,8,26,1851
3,0,4,2,1,4,14,1852
2,4,7,0,0,2,15,1853
1,0,2,1,2,1,7,1856
3,2,5,4,2,6,22,1857
6,2,2,1,3,5,19,1860
3,0,13,0,0,4,20,1861
1,0,6,2,0,4,13,1863
2,3,3,0,0,4,12,1864
3,0,9,2,0,4,18,1865
1,1,16,0,0,2,20,1866
2,2,3,0,1,2,10,1869
5,0,12,0,0,6,23,1870
2,2,4,0,1,2,11,1873
3,2,6,0,0,4,15,1875
4,1,8,3,0,2,18,1877
2,0,12,0,0,3,17,1878
2,0,8,2,0,4,16,1880
5,3,5,1,0,6,20,1881
1,0,9,2,2,4,18,1882
2,1,5,4,1,6,19,1883
1,0,10,1,0,5,17,1885
2,1,2,0,1,1,7,1886
1,0,5,0,0,1,7,1887
2,0,6,0,1,3,12,1888
4,1,7,1,0,4,17,1889
0,0,10,5,0,5,20,1890
2,1,2,0,0,3,8,1892
3,1,10,1,2,0,17,1893
2,0,3,0,0,1,6,1895
3,0,9,2,0,4,18,1897
7,2,8,1,0,8,26,1898
2,1,1,0,0,0,4,1899
1,0,7,1,1,3,13,1900
1,0,8,0,1,1,11,1901
1,1,6,0,0,1,9,1905
4,1,2,1,0,1,9,1908
3,1,7,2,0,5,18,1909
3,3,2,2,2,2,14,1910
2,0,2,0,1,3,8,1911
1,0,4,2,0,6,13,1914
5,0,9,0,0,5,19,1915
3,3,7,1,1,3,18,1916
4,0,4,0,3,5,16,1917
2,0,12,2,0,1,17,1918
0,0,10,1,0,2,13,1919
5,0,5,5,6,7,28,1920
4,0,11,0,0,5,20,1921
2,0,8,0,0,1,11,1922
2,1,7,1,2,3,16,1924
6,3,4,1,3,10,27,1925
2,1,11,1,0,1,16,1927
2,1,7,0,2,8,20,1929
3,1,9,0,1,8,22,1932
7,3,4,0,0,7,21,1933
1,0,21,0,0,1,23,1935
2,0,10,0,0,3,15,1937
2,0,12,2,0,2,18,1938
5,0,10,1,0,5,21,1939
4,1,13,2,1,8,29,1940
5,1,7,0,1,7,21,1941
2,0,4,0,2,2,10,1942
1,0,4,0,0,0,5,1943
5,2,4,1,2,9,23,1945
3,0,9,2,1,4,19,1948
3,2,6,2,1,5,19,1949
2,1,9,3,1,7,23,1950
5,4,7,0,1,6,23,1951
2,0,5,3,0,1,11,1952
7,2,5,0,0,5,19,1953
2,0,7,0,0,4,13,1954
6,2,7,0,1,5,21,1955
7,1,6,0,1,4,19,1956
2,1,4,1,0,2,10,1957
3,1,9,0,0,4,17,1959
3,0,6,0,0,5,14,1960
2,0,5,0,0,2,9,1961
2,0,7,2,3,4,18,1962
3,3,3,2,0,5,16,1963
5,2,6,0,2,6,21,1965
4,1,7,3,1,6,22,1966
3,2,9,0,1,9,24,1967
1,1,9,0,0,5,16,1968
4,1,6,1,0,9,21,1969
0,0,6,1,0,1,8,1971
6,3,6,0,0,9,24,1972
3,3,8,5,0,8,27,1973
3,0,13,2,1,6,25,1975
3,1,4,3,0,6,17,1976
1,0,6,1,0,2,10,1979
0,0,8,1,1,2,12,1980
3,0,13,2,1,6,25,1981
3,0,5,1,0,4,13,1983
3,0,8,0,0,5,16,1985
4,2,6,1,0,4,17,1986
2,0,6,2,2,4,16,1987
0,0,3,1,0,1,5,1989
0,0,3,1,0,3,7,1990
6,1,7,2,0,8,24,1991
3,2,2,2,2,2,13,1992
4,1,5,2,2,8,22,1994
0,0,8,1,1,2,12,1995
3,0,10,2,1,2,18,1996
3,0,13,2,1,6,25,1999
2,0,12,1,0,5,20,2000
3,2,2,2,3,7,19,2001
6,1,6,1,1,2,17,2003
3,0,13,2,1,6,25,2006
1,0,3,1,1,2,8,2007
1,1,5,2,0,7,16,2009
2,0,12,0,1,2,17,2010
3,1,11,1,0,9,25,2012
1,0,5,1,0,3,10,2014
1,0,6,2,0,2,11,2015
1,0,8,0,0,2,11,2016
5,2,6,3,0,10,26,2017
0,0,10,2,0,6,18,2019
5,0,4,2,3,5,19,2020
1,0,12,0,0,9,22,2022
1,0,12,0,1,2,16,2023
1,0,4,2,0,4,11,2024
2,2,4,2,3,9,22,2026
1,0,2,0,0,2,5,2027
4,3,3,2,3,7,22,2028
1,0,8,1,0,5,15,2031
1,1,22,0,0,0,24,2033
4,1,8,0,1,8,22,2034
1,0,8,1,0,3,13,2035
1,0,9,1,0,2,13,2036
1,2,9,2,1,5,20,2038
5,2,6,2,0,9,24,2039
0,0,7,1,0,1,9,2040
4,1,8,0,2,3,18,2042
3,0,10,1,0,5,19,2043
2,0,9,2,0,4,17,2045
3,0,9,1,0,4,17,2046
1,0,7,2,0,5,15,2047
0,0,8,2,0,4,14,2049
2,0,2,2,0,1,7,2050
2,0,7,2,0,4,15,2051
2,0,14,0,1,2,19,2055
5,2,2,0,1,5,15,2056
0,0,7,2,0,5,14,2057
2,1,3,1,0,2,9,2058
0,0,6,0,2,4,12,2059
2,1,13,0,0,2,18,2060
3,0,10,1,0,8,22,2061
0,0,13,2,1,5,21,2063
4,1,10,0,0,7,22,2064
2,0,9,2,0,7,20,2067
2,0,4,4,1,5,16,2068
4,0,11,2,0,7,24,2069
3,0,11,0,0,2,16,2070
0,0,3,0,0,3,6,2071
3,1,8,2,1,3,18,2073
1,1,10,1,0,4,17,2074
0,0,10,0,0,1,11,2075
0,0,14,0,0,0,14,2076
0,0,9,0,0,2,11,2077
3,0,6,2,1,7,19,2078
3,2,7,1,1,5,19,2081
6,3,4,0,1,6,20,2082
1,0,11,1,0,2,15,2083
2,1,1,1,0,2,7,2084
4,1,6,3,3,6,23,2086
4,1,2,0,0,3,10,2087
1,0,7,1,1,1,11,2089
0,0,1,1,1,0,3,2091
3,0,5,1,0,4,13,2094
0,0,2,1,0,1,4,2095
1,0,8,0,0,2,11,2096
2,1,11,0,0,1,15,2097
1,0,4,1,1,0,7,2098
1,0,6,0,1,2,10,2099
3,0,8,2,0,9,22,2100
1,0,12,0,0,2,15,2102
0,0,5,0,0,3,8,2103
5,0,5,1,1,5,17,2108
4,1,4,1,1,2,13,2109
7,1,7,2,0,9,26,2110
1,0,8,1,0,4,14,2111
2,0,6,1,0,4,13,2112
3,0,7,2,0,8,20,2113
2,0,4,0,0,2,8,2114
2,0,10,2,3,7,24,2115
0,0,10,1,0,2,13,2116
4,2,5,0,2,6,19,2117
5,0,5,3,0,7,20,2118
4,0,6,2,1,4,17,2119
0,0,10,1,0,3,14,2121
0,0,3,0,0,0,3,2122
3,0,6,1,1,3,14,2123
4,1,8,0,0,5,18,2125
3,1,4,3,1,6,18,2126
1,0,12,0,0,5,18,2128
1,1,5,2,2,4,15,2129
0,1,6,2,1,4,14,2131
0,0,16,0,1,1,18,2133
0,0,10,1,0,2,13,2134
0,0,10,0,0,1,11,2136
1,1,2,1,0,4,9,2138
0,0,9,0,0,1,10,2139
8,2,7,1,2,7,27,2141
6,4,5,1,1,9,26,2142
0,0,11,0,0,2,13,2144
7,2,6,1,2,8,26,2145
4,2,6,4,0,8,24,2146
2,1,6,1,1,4,15,2148
4,0,7,0,0,2,13,2149
5,1,3,0,1,3,13,2150
4,0,12,4,2,3,25,2153
1,0,5,1,1,4,12,2154
6,3,5,0,1,4,19,2157
3,2,9,2,1,3,20,2158
1,0,4,0,0,4,9,2159
4,1,5,1,0,4,15,2160
4,0,7,3,1,2,17,2161
4,2,8,2,1,2,19,2163
1,0,9,0,1,3,14,2164
1,0,9,0,1,3,14,2169
1,0,9,0,1,3,14,2171
4,0,8,2,0,6,20,2172
1,0,5,0,0,5,11,2173
1,0,9,0,1,3,14,2174
2,1,4,1,1,0,9,2175
3,0,8,4,0,6,21,2176
1,0,6,3,2,3,15,2177
1,0,9,0,1,3,14,2179
1,1,5,6,0,6,19,2181
4,0,10,0,1,4,19,2183
3,1,9,1,1,4,19,2186
1,0,6,0,0,5,12,2188
1,0,5,0,0,5,11,2189
1,0,9,0,1,3,14,2190
2,2,5,3,0,5,17,2191
1,0,9,0,1,3,14,2192
1,0,6,0,0,5,12,2193
4,1,2,0,0,2,9,2194
1,0,9,2,0,8,20,2195
1,0,6,0,0,5,12,2198
2,1,7,3,3,7,23,2203
1,1,6,5,1,6,20,2204
1,0,5,2,0,2,10,2205
1,0,8,2,3,6,20,2207
1,0,8,0,0,2,11,2209
2,0,15,0,0,4,21,2210
1,0,9,0,0,3,13,2211
0,0,11,1,0,5,17,2212
0,0,9,2,0,1,12,2213
2,0,6,2,1,3,14,2214
2,0,10,0,2,4,18,2215
2,0,15,0,0,4,21,2216
3,1,8,1,1,4,18,2217
0,0,12,0,0,0,12,2219
0,0,13,1,0,3,17,2220
2,0,6,1,0,1,10,2221
4,0,10,0,0,5,19,2222
0,0,21,0,0,0,21,2225
1,0,8,0,0,2,11,2227
2,0,10,1,2,2,17,2229
2,1,9,1,1,4,18,2230
3,0,7,0,1,3,14,2231
2,0,12,0,0,6,20,2233
5,1,6,3,0,6,21,2235
0,0,11,0,0,1,12,2236
2,0,9,2,2,2,17,2237
2,0,12,0,0,6,20,2238
1,2,8,0,0,5,16,2239
2,0,10,1,2,2,17,2240
0,0,7,1,0,4,12,2241
2,0,6,0,1,2,11,2242
3,0,8,1,1,6,19,2244
2,2,8,0,2,8,22,2245
5,4,5,0,1,6,21,2246
0,0,11,0,0,5,16,2248
1,0,7,0,0,2,10,2250
1,0,9,1,0,6,17,2251
1,0,12,1,1,4,19,2254
1,0,4,3,0,3,11,2255
2,0,5,0,0,3,10,2256
1,0,11,2,1,6,21,2257
7,3,7,2,1,8,28,2258
4,3,6,1,0,9,23,2260
3,3,1,0,0,4,11,2262
2,3,3,1,0,4,13,2263
2,0,3,1,1,4,11,2265
3,2,1,1,0,4,11,2266
2,0,9,1,0,8,20,2267
3,0,7,0,0,3,13,2271
6,1,5,0,0,5,17,2272
2,1,2,0,0,4,9,2273
4,0,6,1,1,11,23,2274
0,0,4,0,0,2,6,2275
2,2,1,0,0,2,7,2277
3,2,11,0,0,3,19,2278
5,1,4,1,3,11,25,2279
2,2,4,0,1,5,14,2280
2,2,1,0,0,2,7,2281
4,2,3,0,3,5,17,2282
2,0,4,0,0,3,9,2284
3,0,7,0,0,3,13,2285
3,2,3,0,0,4,12,2286
2,0,6,1,0,4,13,2288
2,0,13,1,0,6,22,2289
2,0,12,1,0,8,23,2292
5,2,6,1,3,10,27,2294
0,0,8,1,0,0,9,2296
3,0,7,1,0,7,18,2297
5,2,3,1,3,10,24,2298
4,3,4,2,1,8,22,2299
3,1,11,0,4,4,23,2300
4,2,12,2,0,5,25,2301
1,2,10,0,1,6,20,2303
0,0,7,0,0,1,8,2304
1,0,5,2,0,1,9,2306
4,0,4,1,2,8,19,2307
4,1,5,1,2,5,18,2308
1,0,6,2,0,1,10,2309
3,0,11,0,0,5,19,2311
5,3,3,3,1,7,22,2312
0,0,8,0,0,3,11,2314
2,0,8,2,0,4,16,2315
3,3,5,1,0,7,19,2317
5,2,4,1,0,7,19,2318
3,0,7,1,0,6,17,2319
3,0,12,0,0,3,18,2321
2,0,4,2,1,3,12,2324
2,1,4,0,2,3,12,2325
2,2,7,1,0,1,13,2327
0,0,10,0,0,1,11,2329
2,0,6,1,0,5,14,2330
0,0,5,0,0,0,5,2332
2,2,5,0,0,1,10,2333
0,0,9,0,0,4,13,2334
2,1,10,2,1,8,24,2336
0,0,5,0,0,0,5,2337
6,3,12,1,0,9,31,2339
4,1,5,0,0,3,13,2340
1,0,9,2,0,2,14,2341
1,1,4,0,0,5,11,2342
1,0,12,1,0,3,17,2346
2,2,3,0,1,1,9,2347
2,0,7,0,0,3,12,2348
0,0,12,1,0,1,14,2349
1,0,7,0,0,1,9,2350
0,0,13,2,0,1,16,2351
2,0,1,1,0,2,6,2352
6,4,11,3,1,3,28,2354
3,1,11,4,0,2,21,2356
6,5,6,1,0,8,26,2358
5,0,7,3,0,6,21,2359
1,0,14,1,1,1,18,2361
3,2,6,0,0,4,15,2362
3,1,2,2,3,6,17,2363
3,0,6,2,0,8,19,2364
4,1,10,2,2,5,24,2366
1,0,4,0,0,3,8,2367
4,2,6,1,0,10,23,2368
2,0,13,1,0,4,20,2370
2,2,4,1,0,6,15,2372
1,1,5,0,0,0,7,2373
3,0,6,2,0,8,19,2374
5,2,6,1,1,5,20,2375
2,2,2,0,1,2,9,2376
2,0,6,2,0,7,17,2377
5,3,8,0,1,3,20,2379
4,0,8,3,0,6,21,2382
5,3,8,0,1,3,20,2385
5,3,5,2,2,11,28,2386
2,0,1,0,1,2,6,2387
1,0,10,1,1,1,14,2388
7,4,5,0,1,7,24,2389
7,2,7,2,1,7,26,2390
5,2,4,0,0,3,14,2391
3,3,2,2,2,1,13,2394
2,0,4,1,1,1,9,2395
2,1,3,3,2,0,11,2396
4,1,2,1,1,2,11,2397
2,0,4,1,2,2,11,2398
5,4,1,3,4,3,20,2399
5,3,8,0,1,3,20,2400
1,0,2,0,0,0,3,2402
1,1,16,2,0,4,24,2406
3,1,6,1,0,8,19,2408
2,2,1,0,1,1,7,2409
1,3,4,0,3,5,16,2410
2,0,6,0,3,8,19,2412
2,0,2,0,2,1,7,2413
1,0,11,0,0,6,18,2414
2,0,10,3,1,4,20,2415
3,1,5,1,2,7,19,2416
3,1,2,0,2,1,9,2417
2,1,3,0,0,2,8,2418
0,0,9,0,0,1,10,2419
3,2,4,1,2,0,12,2420
2,1,2,1,0,2,8,2421
1,0,10,1,0,4,16,2422
0,0,5,0,0,0,5,2423
1,1,10,2,0,2,16,2425
3,2,15,0,0,2,22,2427
2,0,11,0,0,5,18,2428
2,1,2,0,2,3,10,2429
1,1,6,1,0,4,13,2430
0,0,4,0,0,4,8,2432
3,4,9,0,3,9,28,2435
1,0,6,0,0,6,13,2437
2,0,6,1,0,3,12,2438
0,0,15,1,0,5,21,2440
0,0,11,2,0,2,15,2441
2,2,5,3,0,3,15,2442
2,0,11,0,1,5,19,2443
1,2,5,3,3,3,17,2445
0,0,9,0,0,3,12,2446
4,1,6,0,3,7,21,2451
0,0,4,1,0,2,7,2452
2,5,3,0,1,8,19,2453
2,1,7,1,0,4,15,2454
5,2,6,1,0,3,17,2455
5,4,4,2,1,9,25,2456
2,2,6,0,0,5,15,2457
1,0,9,4,0,5,19,2458
1,1,9,0,0,5,16,2459
2,0,10,1,0,4,17,2460
4,0,9,0,3,6,22,2462
3,2,6,1,0,5,17,2463
4,0,8,1,0,4,17,2464
3,0,12,2,0,2,19,2465
5,0,9,0,1,3,18,2466
6,2,9,0,0,5,22,2467
2,1,7,0,0,4,14,2468
2,0,5,0,0,2,9,2470
3,0,8,2,1,5,19,2471
1,1,4,0,0,7,13,2475
3,0,17,0,0,7,27,2476
6,4,3,0,2,7,22,2478
2,1,9,1,0,3,16,2479
4,0,7,3,0,8,22,2480
7,5,4,1,4,5,26,2482
7,1,11,1,1,7,28,2483
5,5,4,0,1,10,25,2485
1,0,2,0,1,0,4,2486
2,1,5,0,1,2,11,2487
1,1,9,0,0,5,16,2488
7,0,6,2,0,10,25,2489
7,4,7,1,1,8,28,2490
3,0,11,0,0,8,22,2491
4,1,10,0,1,6,22,2492
3,0,8,1,0,8,20,2493
2,1,9,1,1,5,19,2494
2,0,11,2,0,4,19,2496
4,0,7,3,0,8,22,2497
3,0,5,0,1,7,16,2498
3,0,8,0,0,4,15,2499
3,1,6,1,0,5,16,2500
3,2,9,1,0,3,18,2501
1,1,6,1,1,2,12,2502
3,0,9,2,0,6,20,2504
1,2,6,0,2,4,15,2505
0,0,15,0,0,1,16,2506
1,0,17,0,0,6,24,2507
1,0,13,0,0,7,21,2508
0,0,15,0,0,1,16,2510
1,0,10,3,1,4,19,2512
0,0,16,0,0,0,16,2513
0,0,6,0,0,0,6,2514
3,0,9,2,0,6,20,2515
1,0,5,2,0,4,12,2516
3,0,9,2,0,6,20,2517
0,2,18,0,0,6,26,2519
1,0,11,0,2,4,18,2520
0,0,9,1,0,0,10,2521
0,0,8,1,0,0,9,2523
0,0,16,0,0,0,16,2524
2,1,7,0,0,6,16,2527
0,0,18,0,0,0,18,2528
0,0,14,0,0,0,14,2530
1,0,5,0,0,0,6,2531
5,2,7,1,2,6,23,2532
1,0,6,0,0,2,9,2534
0,0,18,0,0,0,18,2535
2,0,7,3,0,7,19,2536
2,0,11,2,1,7,23,2537
3,3,7,1,2,2,18,2538
2,0,8,3,0,4,17,2539
0,0,9,1,0,1,11,2540
3,0,12,0,0,11,26,2541
2,0,8,0,0,4,14,2542
0,0,14,0,0,1,15,2543
0,0,11,0,0,4,15,2544
2,0,9,1,0,2,14,2545
1,0,6,0,0,2,9,2546
1,0,7,0,0,3,11,2547
0,0,17,0,0,1,18,2548
0,0,6,0,0,0,6,2550
2,1,6,2,2,7,20,2552
4,0,18,4,0,4,30,2553
1,1,4,1,0,4,11,2554
0,1,7,1,0,2,11,2555
4,1,5,1,1,5,17,2556
0,0,5,1,0,1,7,2557
2,1,5,1,0,5,14,2559
4,1,6,0,0,4,15,2560
1,0,4,1,3,0,9,2561
2,2,7,0,0,4,15,2564
0,1,5,0,0,5,11,2565
0,0,8,1,0,1,10,2566
3,1,7,1,0,7,19,2568
1,0,2,1,0,0,4,2569
0,0,4,0,0,0,4,2570
0,0,13,1,0,7,21,2571
2,1,2,0,0,2,7,2572
4,5,6,1,0,9,25,2573
1,0,2,0,0,1,4,2575
0,0,5,1,0,0,6,2576
4,0,9,1,0,6,20,2579
0,1,3,1,0,0,5,2582
4,2,12,0,3,3,24,2585
2,0,9,2,1,5,19,2587
1,0,5,0,0,3,9,2588
1,0,8,2,0,0,11,2590
0,0,6,1,0,0,7,2591
0,0,9,0,0,1,10,2592
2,0,5,0,0,1,8,2593
3,2,0,1,0,4,10,2594
2,0,7,0,0,3,12,2597
3,0,12,0,0,5,20,2598
2,0,4,3,0,1,10,2599
0,0,11,0,0,5,16,2602
4,2,2,1,0,3,12,2603
1,0,8,0,0,3,12,2604
2,0,9,0,0,2,13,2605
3,6,4,0,2,7,22,2606
3,1,11,1,0,4,20,2608
3,0,9,0,2,5,19,2609
5,2,9,2,1,7,26,2611
1,0,7,1,0,4,13,2612
3,0,8,1,2,4,18,2614
2,1,4,2,1,1,11,2616
3,0,6,3,3,3,18,2617
1,1,3,1,0,1,7,2619
3,0,3,2,2,7,17,2621
1,1,2,0,0,0,4,2622
4,1,5,2,3,4,19,2624
1,0,22,1,1,2,27,2625
1,0,4,0,0,1,6,2627
1,0,3,1,1,5,11,2628
4,0,5,2,1,3,15,2629
3,0,8,0,2,3,16,2631
7,5,7,1,3,6,29,2632
3,0,13,0,0,6,22,2633
1,0,12,0,0,2,15,2635
6,0,11,0,0,8,25,2637
1,0,2,2,1,0,6,2640
9,7,2,0,2,6,26,2641
3,4,4,2,3,5,21,2642
4,3,6,0,2,4,19,2643
4,1,7,4,4,4,24,2644
1,2,4,2,0,4,13,2645
4,0,6,2,0,3,15,2647
3,0,10,0,2,3,18,2648
1,0,8,2,1,6,18,2649
3,0,6,1,1,1,12,2651
2,3,6,1,2,4,18,2655
0,0,4,0,0,0,4,2656
1,1,7,0,0,1,10,2657
1,2,4,0,3,2,12,2658
5,5,3,1,4,1,19,2659
1,0,2,0,0,0,3,2660
1,1,7,1,0,2,12,2661
1,1,4,1,0,1,8,2663
0,0,4,0,0,0,4,2664
1,0,3,0,0,1,5,2666
0,1,3,1,0,0,5,2667
2,2,4,1,0,0,9,2668
2,2,4,1,1,3,13,2670
0,0,5,1,0,0,6,2671
1,0,3,0,0,2,6,2672
1,1,4,0,0,2,8,2673
0,0,8,0,0,2,10,2675
1,0,5,3,1,2,12,2676
0,0,6,1,1,1,9,2677
4,4,1,2,1,4,16,2679
6,2,7,2,0,5,22,2680
1,0,4,1,2,2,10,2682
1,2,4,1,0,4,12,2683
1,1,3,1,1,1,8,2684
1,2,2,1,0,2,8,2687
4,0,4,1,0,2,11,2688
0,0,5,0,0,0,5,2689
3,2,3,2,2,5,17,2691
1,0,3,0,0,1,5,2692
0,0,6,0,0,0,6,2693
1,0,3,0,0,1,5,2694
0,0,4,1,0,2,7,2695
3,0,3,1,4,6,17,2696
3,0,6,0,0,5,14,2698
0,0,5,0,0,0,5,2700
6,6,2,0,2,2,18,2701
0,0,4,1,0,0,5,2702
1,0,0,0,0,0,1,2703
2,0,2,0,0,2,6,2706
2,0,2,0,0,1,5,2707
0,0,6,0,0,0,6,2708
1,1,1,0,0,0,3,2709
1,0,11,0,0,3,15,2711
1,2,8,2,2,5,20,2714
0,0,3,0,0,0,3,2715
0,0,6,1,0,1,8,2719
1,0,4,1,0,2,8,2720
5,1,6,1,4,9,26,2723
1,1,3,0,0,1,6,2724
4,1,4,0,2,2,13,2725
1,0,9,0,0,3,13,2726
5,2,6,0,1,4,18,2727
3,2,3,1,2,2,13,2728
2,0,4,1,0,1,8,2729
1,1,9,0,0,10,21,2730
1,0,2,0,1,1,5,2731
2,0,3,0,0,2,7,2732
1,0,9,0,0,3,13,2733
3,0,4,0,0,2,9,2734
1,1,9,0,0,10,21,2736
2,1,3,0,2,1,9,2739
2,0,2,0,0,1,5,2740
1,0,9,2,0,1,13,2741
6,2,4,1,2,6,21,2743
3,0,15,4,0,0,22,2744
1,1,5,0,0,3,10,2748
1,1,5,0,0,2,9,2749
2,0,10,4,1,3,20,2752
2,0,4,0,0,2,8,2753
4,0,12,1,0,5,22,2755
1,0,3,0,0,1,5,2756
1,0,3,0,0,4,8,2757
6,1,5,6,2,5,25,2758
2,0,5,0,1,4,12,2759
5,0,9,0,1,4,19,2760
1,0,5,1,2,8,17,2761
2,2,2,0,0,1,7,2763
2,2,2,0,1,2,9,2765
0,0,7,0,0,0,7,2766
0,0,20,0,0,9,29,2767
2,2,4,1,1,1,11,2768
3,2,2,0,1,1,9,2769
2,2,5,1,2,6,18,2770
1,0,2,1,0,2,6,2771
2,2,2,1,0,3,10,2773
3,1,5,2,0,6,17,2774
2,2,5,1,0,5,15,2777
1,0,3,0,0,1,5,2778
3,1,10,1,1,10,26,2780
2,0,7,2,0,6,17,2782
7,2,7,1,1,8,26,2783
4,0,3,1,3,3,14,2784
1,2,4,2,0,1,10,2785
6,2,5,0,1,7,21,2786
0,0,19,0,0,8,27,2787
6,0,5,2,1,11,25,2788
0,0,20,0,0,9,29,2792
4,1,17,1,2,5,30,2793
2,1,3,0,1,2,9,2794
1,1,1,1,0,1,5,2795
3,1,6,1,0,7,18,2796
0,0,6,0,0,1,7,2797
4,4,5,1,4,12,30,2799
2,1,4,2,0,5,14,2801
0,0,10,0,0,2,12,2802
0,0,6,0,0,0,6,2803
4,2,8,1,0,7,22,2807
0,0,17,1,0,2,20,2808
5,3,4,2,1,7,22,2811
6,2,3,2,0,6,19,2813
1,0,18,0,0,3,22,2815
2,2,4,0,0,7,15,2817
0,0,9,0,0,3,12,2819
0,0,9,1,0,2,12,2820
0,0,19,0,0,4,23,2821
2,1,8,0,1,4,16,2822
1,0,6,1,0,1,9,2825
3,2,7,0,0,3,15,2826
0,0,14,0,0,6,20,2827
2,0,8,1,1,5,17,2828
5,2,8,0,0,7,22,2829
1,0,3,0,0,1,5,2830
0,0,9,0,0,3,12,2831
0,0,11,0,0,0,11,2832
2,0,7,3,1,4,17,2833
1,1,9,0,0,7,18,2835
0,0,13,0,0,2,15,2836
1,0,3,0,0,3,7,2838
0,0,17,0,0,1,18,2839
0,0,15,0,0,2,17,2841
0,0,15,3,0,3,21,2842
4,2,4,0,0,3,13,2843
0,0,6,0,0,3,9,2844
2,0,4,3,0,6,15,2846
1,0,14,0,1,3,19,2849
2,0,11,0,1,4,18,2851
2,0,8,1,0,6,17,2852
3,3,5,1,2,4,18,2853
0,1,2,2,0,3,8,2854
4,2,6,4,1,5,22,2855
1,1,10,1,0,2,15,2856
0,0,12,0,0,5,17,2857
0,0,4,1,0,0,5,2858
5,2,9,0,1,9,26,2860
1,0,6,0,0,1,8,2861
1,0,5,1,0,4,11,2863
2,0,4,1,1,5,13,2864
1,1,2,1,3,2,10,2865
3,0,5,1,0,3,12,2866
4,2,9,3,2,8,28,2867
1,0,5,0,0,1,7,2869
2,0,4,0,0,3,9,2870
3,1,9,1,1,7,22,2871
0,0,9,0,0,3,12,2872
7,3,3,4,3,7,27,2873
4,2,6,3,1,7,23,2875
6,3,6,0,0,4,19,2877
2,0,8,1,1,2,14,2878
5,2,5,1,0,3,16,2879
6,3,6,1,2,7,25,2880
5,1,5,1,0,6,18,2881
0,0,4,0,0,0,4,2882
4,0,6,0,0,2,12,2883
5,1,8,6,0,4,24,2884
4,0,7,1,1,2,15,2885
1,1,3,0,0,1,6,2886
3,2,5,1,1,3,15,2887
0,1,17,1,0,2,21,2888
0,0,6,1,0,3,10,2889
0,0,16,0,0,4,20,2890
3,0,7,1,0,7,18,2891
1,0,10,1,0,2,14,2893
1,0,9,3,0,5,18,2895
2,1,7,1,0,3,14,2896
1,0,2,1,0,3,7,2898
1,1,6,0,0,1,9,2899
0,0,2,2,0,0,4,2900
5,4,5,1,1,4,20,2902
3,2,7,1,2,8,23,2905
6,2,5,2,2,8,25,2907
1,0,3,0,0,1,5,2908
2,0,10,1,1,4,18,2909
3,0,6,2,1,3,15,2910
1,1,9,2,0,4,17,2911
2,0,5,2,3,3,15,2912
2,2,2,0,0,5,11,2913
2,2,8,3,0,7,22,2915
3,2,6,1,1,5,18,2916
2,2,6,2,1,4,17,2917
3,2,9,1,0,7,22,2920
0,0,11,1,0,0,12,2921
5,3,5,4,0,7,24,2922
1,0,5,0,1,3,10,2924
1,0,9,2,0,6,18,2925
1,0,2,1,2,1,7,2927
0,0,11,0,1,0,12,2929
3,1,4,3,0,3,14,2931
2,3,4,1,0,3,13,2932
1,0,7,3,1,3,15,2933
3,0,10,1,0,10,24,2934
0,0,11,1,0,0,12,2935
1,0,11,0,0,0,12,2936
0,0,7,0,0,3,10,2937
6,2,6,0,1,7,22,2939
4,1,5,1,1,4,16,2941
0,0,6,0,1,0,7,2942
1,0,8,2,0,3,14,2943
4,0,8,1,1,7,21,2944
2,2,6,3,1,10,24,2945
2,2,3,0,1,2,10,2946
1,2,4,2,1,7,17,2947
2,3,10,0,1,7,23,2948
2,2,8,3,2,9,26,2950
7,2,7,0,0,10,26,2952
0,0,4,0,0,4,8,2953
2,0,8,3,0,7,20,2954
1,0,6,6,3,5,21,2955
3,3,5,2,2,1,16,2956
6,0,5,3,1,3,18,2957
2,1,6,1,0,4,14,2959
2,3,8,2,0,4,19,2960
3,1,4,2,1,5,16,2963
1,0,2,3,0,0,6,2965
7,4,3,5,5,4,28,2969
4,1,8,1,1,2,17,2970
0,0,11,2,1,5,19,2971
1,0,9,3,0,2,15,2973
10,6,3,4,1,8,32,2974
2,1,1,2,0,1,7,2975
2,0,3,0,1,0,6,2976
2,1,5,9,3,6,26,2980
0,0,8,1,0,4,13,2982
4,6,9,2,1,6,28,2983
2,0,8,2,1,5,18,2984
2,0,3,1,3,4,13,2987
0,0,5,0,0,0,5,2988
4,1,8,4,2,10,29,2990
1,0,5,1,0,1,8,2991
2,1,4,3,0,2,12,2992
0,0,8,0,0,1,9,2993
2,1,2,2,0,0,7,2995
1,1,1,1,0,0,4,2998
4,1,4,2,1,6,18,3000
2,0,4,3,0,0,9,3001
4,7,6,2,1,8,28,3003
4,5,6,1,2,5,23,3004
1,1,3,0,1,2,8,3005
3,1,2,0,0,0,6,3006
2,1,3,1,2,2,11,3009
0,0,5,0,0,2,7,3010
0,0,11,1,0,3,15,3011
2,1,2,0,1,4,10,3012
1,1,7,1,1,3,14,3013
5,2,8,0,1,5,21,3014
1,1,1,0,0,1,4,3015
1,1,7,1,0,2,12,3016
8,6,5,0,1,4,24,3018
1,0,8,1,0,2,12,3019
3,3,5,2,0,3,16,3021
3,0,7,0,1,9,20,3022
3,1,2,2,2,1,11,3023
1,0,4,0,0,0,5,3025
1,0,2,0,0,1,4,3026
2,0,1,0,0,2,5,3027
1,0,10,0,0,3,14,3029
1,0,4,0,0,0,5,3030
1,1,4,1,0,1,8,3034
5,1,11,0,0,9,26,3036
1,0,11,0,0,4,16,3037
3,0,10,1,1,2,17,3038
1,1,3,0,0,1,6,3039
1,1,6,3,0,1,12,3042
4,3,7,2,0,6,22,3043
0,0,11,0,0,2,13,3044
0,0,5,0,0,3,8,3045
2,0,5,1,1,4,13,3047
1,0,7,0,1,4,13,3048
1,1,4,0,0,4,10,3049
1,1,2,0,0,3,7,3051
1,0,7,2,0,1,11,3052
1,1,9,1,1,9,22,3053
3,6,16,5,1,7,38,3054
4,0,6,1,2,4,17,3055
1,1,18,3,0,5,28,3056
0,0,4,1,0,1,6,3057
6,1,8,1,1,6,23,3058
5,0,7,4,0,7,23,3059
3,0,7,4,0,8,22,3060
3,1,5,2,0,7,18,3061
1,1,9,2,0,9,22,3062
2,4,7,3,0,8,24,3064
0,0,8,2,0,3,13,3066
2,0,9,2,0,6,19,3068
1,0,3,1,1,1,7,3070
2,0,8,4,3,4,21,3071
1,1,9,2,0,2,15,3072
0,0,2,0,0,1,3,3073
6,3,5,1,1,8,24,3074
2,0,10,3,0,6,21,3075
2,0,4,2,0,3,11,3077
0,0,2,0,0,1,3,3079
2,2,7,1,3,7,22,3080
0,0,9,0,0,2,11,3082
5,2,8,2,3,4,24,3083
1,0,4,1,0,1,7,3084
3,2,8,2,1,9,25,3085
3,1,8,0,0,8,20,3086
5,1,4,4,1,5,20,3089
1,0,9,1,1,4,16,3090
5,2,4,2,0,5,18,3091
3,0,9,1,0,7,20,3092
3,1,8,0,0,8,20,3093
1,0,4,1,0,3,9,3095
5,0,5,1,1,4,16,3097
4,0,8,3,1,5,21,3099
2,1,6,1,0,9,19,3100
2,4,7,3,0,8,24,3101
2,0,10,3,0,6,21,3102
5,0,11,0,0,5,21,3104
1,0,8,1,1,5,16,3105
3,0,8,0,0,2,13,3106
2,0,9,0,0,2,13,3107
1,0,2,0,0,2,5,3108
3,0,8,0,0,2,13,3109
3,0,8,0,0,3,14,3111
3,0,8,0,0,2,13,3112
2,0,13,0,0,3,18,3114
1,0,12,0,1,2,16,3115
1,0,12,0,1,2,16,3116
3,0,9,1,0,9,22,3117
3,0,8,0,0,2,13,3118
3,0,8,1,0,3,15,3119
2,0,11,1,0,1,15,3120
1,0,8,1,0,1,11,3122
3,0,14,0,0,3,20,3123
3,0,6,2,0,2,13,3124
2,0,9,1,0,2,14,3125
3,0,8,0,0,2,13,3126
2,0,6,1,0,2,11,3130
3,0,6,0,0,2,11,3131
1,1,6,0,0,4,12,3132
3,0,10,0,0,2,15,3133
2,0,6,0,0,1,9,3134
4,0,4,1,0,2,11,3136
3,0,8,0,0,3,14,3137
3,0,8,1,0,3,15,3138
2,0,11,0,0,2,15,3139
4,0,8,1,0,4,17,3140
3,0,13,0,0,5,21,3141
2,0,8,0,0,1,11,3142
4,0,7,0,0,4,15,3144
2,0,4,0,0,1,7,3145
3,0,13,0,0,2,18,3147
3,1,11,0,0,2,17,3150
2,0,7,0,0,4,13,3152
4,1,4,1,1,2,13,3153
4,2,5,1,0,3,15,3154
4,1,5,1,2,5,18,3155
4,0,7,3,0,9,23,3157
0,0,7,0,0,0,7,3158
7,3,4,2,1,7,24,3159
1,0,8,2,0,6,17,3161
1,0,6,0,0,0,7,3162
0,1,9,3,1,6,20,3163
1,0,7,0,0,3,11,3165
4,0,7,0,2,8,21,3166
2,1,5,3,1,6,18,3167
1,0,4,0,0,0,5,3168
2,0,5,0,0,6,13,3170
2,0,7,5,2,6,22,3171
5,1,6,2,3,6,23,3172
5,2,9,1,1,7,25,3173
0,0,6,3,0,8,17,3174
1,1,5,1,0,3,11,3175
1,1,6,2,1,1,12,3176
1,1,9,1,1,7,20,3177
3,2,6,2,1,2,16,3179
3,0,5,2,3,11,24,3180
3,1,5,3,1,9,22,3181
2,2,6,0,1,1,12,3182
3,0,4,2,1,4,14,3183
1,0,14,2,1,4,22,3184
6,1,9,2,0,7,25,3185
2,2,4,3,1,4,16,3186
1,0,3,0,0,3,7,3188
2,1,10,2,0,8,23,3189
1,0,8,2,1,5,17,3190
1,0,9,1,0,3,14,3191
7,5,3,2,1,8,26,3192
3,1,9,0,2,5,20,3193
6,1,5,1,3,7,23,3195
5,1,9,2,0,8,25,3196
2,0,5,0,0,3,10,3197
3,0,10,2,1,6,22,3198
6,2,6,1,2,6,23,3199
7,2,10,0,2,5,26,3200
0,0,12,1,0,5,18,3201
4,1,6,0,1,2,14,3205
5,1,3,2,1,3,15,3210
5,0,9,0,1,11,26,3211
1,0,6,1,0,1,9,3212
4,0,10,1,1,11,27,3216
5,0,7,2,2,7,23,3217
4,0,10,1,1,9,25,3218
4,0,11,0,1,11,27,3219
3,1,4,1,0,3,12,3221
3,0,11,0,1,10,25,3222
6,4,7,1,1,7,26,3225
3,1,4,1,0,3,12,3227
5,2,4,1,0,5,17,3229
6,0,4,0,0,1,11,3231
6,0,9,0,1,11,27,3235
2,0,8,3,0,5,18,3236
4,0,10,1,1,10,26,3237
3,0,10,0,1,11,25,3239
4,0,10,2,1,10,27,3240
3,0,10,1,0,6,20,3241
4,1,4,1,0,2,12,3242
4,0,10,1,1,10,26,3243
5,0,10,1,1,11,28,3244
6,2,2,3,1,4,18,3245
2,0,4,1,0,1,8,3248
5,2,6,1,2,10,26,3249
4,0,6,4,1,2,17,3252
2,0,7,3,2,8,22,3253
1,0,6,2,0,2,11,3255
1,0,10,2,0,2,15,3256
5,2,11,1,0,4,23,3259
1,1,3,1,1,3,10,3260
3,0,10,0,0,4,17,3262
5,3,7,1,0,6,22,3263
2,0,4,1,0,2,9,3264
0,0,6,2,0,0,8,3265
1,0,6,2,0,2,11,3266
1,0,6,2,0,2,11,3270
1,0,9,1,0,2,13,3274
2,2,7,1,2,7,21,3275
1,1,8,0,0,0,10,3276
1,1,3,1,1,1,8,3277
0,1,3,0,0,2,6,3278
1,0,9,3,0,2,15,3280
4,3,4,1,2,6,20,3281
1,0,13,1,2,2,19,3282
3,2,7,1,2,10,25,3283
2,0,6,0,0,0,8,3284
1,1,5,1,1,2,11,3285
2,1,6,1,3,4,17,3286
1,1,2,0,1,2,7,3287
2,0,4,1,1,2,10,3288
1,0,15,2,0,2,20,3289
3,1,5,3,0,6,18,3292
7,5,4,1,2,5,24,3295
4,1,8,1,0,9,23,3296
5,5,5,2,2,6,25,3297
6,2,5,1,0,6,20,3299
1,1,10,1,0,5,18,3300
3,3,7,3,2,7,25,3301
2,1,4,1,2,2,12,3302
1,0,6,1,0,3,11,3303
1,0,2,0,0,1,4,3304
3,1,4,0,1,4,13,3308
3,0,7,2,0,6,18,3309
4,2,3,1,1,4,15,3311
8,2,4,1,5,5,25,3312
2,1,3,0,1,1,8,3317
2,3,9,2,1,5,22,3318
4,0,6,1,0,8,19,3319
2,2,4,1,1,0,10,3320
4,1,5,2,2,8,22,3322
2,1,2,0,1,3,9,3323
5,1,5,0,0,3,14,3324
1,0,1,0,1,1,4,3328
4,1,5,2,2,8,22,3329
4,0,9,2,1,6,22,3334
5,0,3,0,1,4,13,3335
5,0,10,2,1,5,23,3336
1,0,10,1,0,4,16,3337
2,0,4,1,1,3,11,3338
4,1,5,2,2,8,22,3339
4,1,5,1,2,6,19,3340
1,0,4,1,0,2,8,3341
1,1,2,1,0,0,5,3342
2,0,4,1,0,2,9,3345
3,1,6,0,4,2,16,3346
1,0,3,2,1,2,9,3347
0,0,11,0,0,2,13,3351
1,0,5,1,0,3,10,3355
2,2,3,2,1,3,13,3356
1,0,14,0,1,1,17,3357
0,0,2,1,3,4,10,3359
3,0,6,0,1,1,11,3361
3,0,6,1,1,6,17,3362
2,0,4,0,0,3,9,3363
1,0,7,0,0,4,12,3364
4,2,5,3,3,4,21,3365
3,0,8,0,0,6,17,3367
4,2,3,1,2,4,16,3368
0,0,6,0,0,2,8,3369
0,0,10,0,0,4,14,3370
0,0,5,0,0,0,5,3372
0,0,15,0,0,6,21,3373
1,0,6,0,0,4,11,3376
1,0,1,1,2,0,5,3377
2,1,5,3,0,1,12,3379
0,0,4,2,0,0,6,3380
5,1,6,2,0,9,23,3381
3,0,6,0,0,7,16,3383
0,0,15,0,0,6,21,3387
4,1,11,0,0,6,22,3388
2,1,8,0,1,5,17,3389
1,0,8,0,0,0,9,3390
0,0,8,0,0,2,10,3391
5,2,6,0,0,4,17,3393
1,0,5,0,0,2,8,3394
2,1,8,0,0,3,14,3395
3,0,7,0,0,4,14,3396
2,0,8,2,0,0,12,3397
2,0,8,2,0,7,19,3398
2,0,8,1,0,3,14,3400
1,0,7,0,1,0,9,3401
3,1,5,2,0,5,16,3402
4,2,11,2,1,8,28,3403
3,1,5,1,1,4,15,3404
5,2,9,1,0,7,24,3405
4,2,12,1,1,8,28,3406
10,4,6,1,1,4,26,3408
3,0,6,2,0,6,17,3410
2,3,6,3,1,6,21,3411
1,0,11,0,0,1,13,3412
4,1,8,1,1,5,20,3413
4,2,11,2,1,8,28,3414
2,0,6,3,0,6,17,3415
1,0,11,0,0,1,13,3417
5,1,3,2,2,4,17,3418
4,0,6,0,0,4,14,3419
4,2,11,2,1,8,28,3421
2,0,5,0,0,1,8,3423
4,2,11,2,1,8,28,3425
2,2,8,2,0,7,21,3428
2,1,1,1,0,3,8,3429
2,0,8,3,0,5,18,3430
1,0,11,0,0,1,13,3431
2,0,9,0,0,4,15,3432
3,0,3,1,0,1,8,3433
1,0,10,0,0,3,14,3435
1,0,6,1,0,4,12,3436
2,0,6,3,0,6,17,3437
3,0,4,0,0,2,9,3439
6,1,8,1,0,6,22,3440
4,2,11,2,1,8,28,3445
0,0,11,0,0,3,14,3446
5,2,6,1,1,8,23,3447
3,0,4,1,1,2,11,3448
4,0,10,0,0,4,18,3450
3,1,6,1,0,4,15,3451
1,0,7,1,0,2,11,3452
4,1,4,1,0,5,15,3455
5,0,7,4,2,4,22,3459
1,0,10,3,0,3,17,3460
4,1,9,1,1,6,22,3462
1,0,20,0,0,0,21,3463
4,3,2,2,2,2,15,3464
3,1,6,2,0,5,17,3465
5,1,5,4,0,4,19,3466
1,1,3,1,0,1,7,3468
3,0,14,2,0,3,22,3469
2,0,6,0,0,6,14,3470
0,0,8,0,0,2,10,3471
8,1,5,3,3,10,30,3472
1,0,3,0,0,3,7,3473
4,0,10,1,0,6,21,3474
2,1,9,0,0,4,16,3475
4,0,10,2,2,8,26,3476
3,0,9,1,0,4,17,3477
6,1,9,0,0,8,24,3478
3,0,9,1,1,6,20,3480
6,1,5,2,2,9,25,3481
6,1,12,0,0,8,27,3482
2,0,2,1,0,2,7,3483
4,2,2,1,5,6,20,3484
5,1,5,1,0,6,18,3485
2,0,8,1,0,3,14,3486
4,0,8,4,0,9,25,3487
2,0,10,1,1,10,24,3489
2,1,6,2,0,8,19,3490
0,1,9,0,0,1,11,3492
2,3,7,0,1,2,15,3493
1,0,2,3,0,2,8,3494
2,1,5,1,0,4,13,3495
1,0,8,0,0,6,15,3497
1,0,12,0,0,6,19,3498
6,1,5,2,2,6,22,3499
2,1,13,0,3,1,20,3500
1,0,2,0,0,3,6,3501
1,0,7,1,0,0,9,3503
2,0,5,3,0,6,16,3504
1,0,7,1,0,0,9,3505
3,0,9,2,3,4,21,3506
2,0,9,2,0,0,13,3508
6,2,12,5,0,4,29,3509
2,0,8,1,0,0,11,3510
2,0,8,1,0,0,11,3512
1,0,7,1,1,11,21,3513
0,0,11,1,0,2,14,3514
1,0,7,1,0,0,9,3517
2,0,12,1,0,7,22,3518
2,0,6,1,1,1,11,3519
2,0,12,1,0,7,22,3520
2,2,6,0,2,9,21,3521
1,0,7,1,0,0,9,3522
0,1,16,0,0,4,21,3523
2,0,12,1,0,7,22,3524
5,3,4,3,2,4,21,3525
1,0,7,1,0,1,10,3526
1,0,7,4,0,5,17,3527
4,0,6,0,1,2,13,3528
2,0,5,2,0,4,13,3529
5,0,9,1,0,2,17,3530
2,0,6,0,0,3,11,3531
2,0,11,1,0,6,20,3532
1,0,8,2,0,4,15,3533
1,0,7,4,0,5,17,3534
2,0,7,0,0,3,12,3535
1,0,6,2,0,4,13,3536
0,0,8,1,0,2,11,3537
1,0,8,1,0,1,11,3540
0,0,9,0,2,5,16,3542
2,1,7,1,0,9,20,3543
2,1,8,3,1,10,25,3544
0,0,8,1,0,4,13,3548
0,0,11,1,0,2,14,3549
3,0,9,2,0,5,19,3550
1,0,7,1,0,0,9,3552
5,0,8,1,2,6,22,3554
2,2,7,1,1,6,19,3555
3,0,11,0,1,7,22,3557
1,0,8,0,0,2,11,3560
2,0,6,2,1,4,15,3565
1,0,8,1,0,5,15,3566
1,0,7,0,0,5,13,3567
7,1,5,2,2,7,24,3568
2,0,9,1,1,5,18,3569
0,0,5,1,0,4,10,3570
5,2,7,1,1,4,20,3572
3,0,5,2,1,11,22,3573
3,4,6,2,0,8,23,3575
1,0,4,1,0,0,6,3578
3,1,4,3,1,2,14,3581
2,1,14,2,0,4,23,3582
2,3,7,0,0,9,21,3583
4,2,7,2,1,8,24,3584
1,0,1,0,0,0,2,3585
2,1,4,1,1,2,11,3587
2,3,7,0,0,9,21,3588
2,1,15,1,0,4,23,3589
3,0,0,1,2,2,8,3591
3,1,8,1,0,7,20,3592
0,0,6,0,0,3,9,3593
1,0,7,1,0,6,15,3594
5,2,4,2,3,6,22,3595
4,1,3,0,0,2,10,3596
1,1,8,3,0,4,17,3597
0,0,5,0,0,3,8,3598
4,1,8,2,1,8,24,3602
0,0,10,1,0,4,15,3603
1,0,12,1,1,3,18,3604
5,0,7,1,2,5,20,3607
4,1,5,2,1,5,18,3608
1,1,4,1,0,5,12,3609
2,1,8,3,0,5,19,3610
1,0,14,2,0,2,19,3611
0,1,12,2,0,6,21,3613
1,1,10,2,1,6,21,3617
2,0,4,1,0,7,14,3618
1,1,8,1,1,4,16,3619
2,1,5,1,0,6,15,3621
0,0,8,1,0,2,11,3623
2,1,6,0,0,6,15,3625
0,0,11,1,1,4,17,3626
3,0,10,1,1,6,21,3627
5,1,8,1,0,3,18,3628
2,3,8,3,3,5,24,3629
5,4,7,2,0,9,27,3631
2,1,6,3,1,10,23,3632
1,1,10,0,0,5,17,3633
0,1,8,2,0,6,17,3634
0,0,10,0,0,7,17,3635
1,0,9,2,0,3,15,3636
3,2,8,2,1,5,21,3637
4,1,7,1,1,6,20,3638
2,2,4,2,1,3,14,3639
3,1,8,0,1,5,18,3640
0,0,5,0,0,4,9,3641
2,0,8,1,1,3,15,3642
0,0,3,0,0,2,5,3643
1,0,11,0,0,4,16,3645
4,3,8,1,0,7,23,3646
0,1,7,0,0,0,8,3647
3,0,6,3,0,3,15,3648
1,0,1,1,1,1,5,3650
4,0,7,1,0,8,20,3652
2,2,4,1,0,1,10,3653
3,4,2,1,1,2,13,3655
0,0,13,0,0,2,15,3656
6,1,5,1,1,5,19,3657
3,2,9,0,0,3,17,3658
1,0,5,2,1,2,11,3659
3,1,4,3,1,1,13,3660
2,1,6,0,1,5,15,3661
2,2,8,0,0,5,17,3662
1,0,7,0,0,2,10,3663
5,1,8,0,1,8,23,3664
1,2,5,1,0,4,13,3666
1,1,10,1,0,3,16,3667
5,2,6,1,1,9,24,3669
1,1,1,2,0,1,6,3670
3,0,6,2,0,3,14,3674
3,0,7,2,0,6,18,3675
2,0,7,1,2,10,22,3676
3,0,8,2,0,8,21,3679
5,4,6,1,1,4,21,3680
2,1,9,0,0,4,16,3681
1,1,4,0,0,6,12,3682
1,2,7,0,0,0,10,3683
1,0,8,2,0,1,12,3684
1,0,1,0,0,1,3,3685
2,1,2,0,2,1,8,3686
8,3,6,0,1,5,23,3689
5,1,8,1,0,8,23,3690
4,4,4,0,1,9,22,3691
2,1,5,1,0,1,10,3692
1,0,2,0,0,1,4,3694
5,1,7,5,1,4,23,3695
4,2,7,1,1,8,23,3696
4,4,7,0,2,8,25,3697
1,0,5,2,0,3,11,3700
3,0,11,0,0,0,14,3702
3,0,9,0,0,7,19,3704
7,4,6,2,2,2,23,3705
3,1,5,5,1,3,18,3708
1,1,0,1,1,0,4,3710
0,0,2,1,0,0,3,3712
6,2,6,2,0,3,19,3713
1,0,6,1,0,3,11,3715
4,0,7,2,1,6,20,3717
3,0,9,0,0,7,19,3718
3,0,9,0,0,7,19,3719
3,0,10,2,0,8,23,3721
3,0,9,0,0,7,19,3722
1,0,6,1,1,5,14,3723
6,1,3,1,1,2,14,3724
4,0,7,1,1,5,18,3725
2,3,1,0,0,1,7,3726
7,2,3,1,1,6,20,3727
3,0,6,1,1,3,14,3729
6,4,6,0,0,7,23,3730
2,0,13,1,0,3,19,3735
4,0,7,2,1,6,20,3736
4,2,9,0,0,10,25,3737
3,0,9,0,0,7,19,3738
1,1,11,1,0,2,16,3739
3,0,12,2,0,2,19,3741
3,0,9,0,0,7,19,3742
4,2,6,0,0,7,19,3743
5,2,5,4,0,2,18,3744
1,0,9,0,0,3,13,3745
3,0,9,0,0,7,19,3747
0,0,9,2,0,5,16,3748
2,1,7,1,0,7,18,3750
1,0,6,2,1,6,16,3752
1,0,4,1,0,2,8,3753
2,0,9,1,0,5,17,3754
2,0,9,1,0,4,16,3756
1,0,5,1,0,5,12,3758
2,2,6,3,1,4,18,3759
2,0,3,4,3,0,12,3760
1,0,9,1,0,1,12,3761
0,0,7,0,0,0,7,3763
1,1,4,1,0,2,9,3764
1,0,7,4,0,5,17,3765
5,2,5,0,0,10,22,3766
0,0,3,0,0,1,4,3768
1,0,5,1,0,3,10,3770
4,1,5,2,1,4,17,3771
4,0,4,1,1,7,17,3772
1,0,6,2,1,6,16,3773
3,3,3,0,1,0,10,3774
4,5,2,1,1,3,16,3775
0,0,5,0,0,1,6,3776
1,0,6,2,1,6,16,3777
1,0,2,0,1,2,6,3778
2,0,7,0,0,13,22,3780
2,2,5,3,1,7,20,3785
0,0,2,1,0,3,6,3786
0,0,4,0,0,0,4,3787
3,1,10,0,0,10,24,3788
0,0,12,1,0,4,17,3789
2,0,1,0,1,1,5,3793
2,0,5,1,1,1,10,3795
2,1,2,2,1,3,11,3796
1,2,2,0,1,2,8,3797
4,5,4,0,0,5,18,3798
5,1,8,1,0,2,17,3800
0,0,8,0,0,0,8,3802
0,0,8,0,0,0,8,3803
3,2,5,1,2,2,15,3805
4,5,4,0,0,5,18,3806
3,2,2,0,0,2,9,3807
0,0,8,0,0,1,9,3810
4,0,9,0,0,7,20,3812
4,5,4,0,0,5,18,3814
0,0,9,0,0,1,10,3815
0,0,11,1,0,0,12,3816
5,1,8,1,1,7,23,3819
3,2,4,1,3,5,18,3820
0,0,8,0,0,1,9,3821
0,0,9,0,0,2,11,3822
2,0,6,0,0,4,12,3824
0,0,2,1,2,1,6,3825
3,4,9,2,1,6,25,3826
0,0,11,0,0,0,11,3827
4,5,4,0,0,5,18,3828
0,0,12,0,0,2,14,3829
0,0,8,0,0,1,9,3830
0,0,8,0,0,1,9,3831
1,0,2,1,0,7,11,3832
1,0,8,0,0,2,11,3833
2,1,7,1,2,3,16,3834
6,1,8,1,0,8,24,3835
4,5,4,0,0,5,18,3836
0,0,9,0,0,0,9,3837
5,1,6,2,1,3,18,3838
0,0,8,3,0,5,16,3839
0,0,11,0,0,0,11,3840
4,5,4,0,0,5,18,3841
2,0,19,0,0,2,23,3842
3,1,9,1,1,4,19,3845
1,0,8,2,0,3,14,3848
0,0,9,0,0,1,10,3849
0,0,8,0,0,0,8,3850
0,0,8,0,0,0,8,3851
0,0,8,0,0,0,8,3853
1,0,7,0,0,1,9,3855
2,1,5,2,0,2,12,3857
5,2,6,1,0,8,22,3858
3,0,4,2,1,2,12,3859
1,0,7,2,0,3,13,3860
0,0,8,0,0,0,8,3861
0,0,9,0,0,0,9,3862
0,0,9,0,0,1,10,3864
0,0,9,1,0,0,10,3866
1,0,5,1,0,2,9,3868
0,0,9,0,0,0,9,3869
0,0,8,0,0,0,8,3870
2,0,11,2,0,4,19,3873
0,0,9,1,0,0,10,3874
0,0,10,1,0,0,11,3875
0,0,6,1,0,3,10,3876
2,1,10,0,1,5,19,3877
1,0,9,3,0,0,13,3879
0,0,10,1,0,0,11,3887
1,0,9,2,0,2,14,3888
1,0,9,3,0,0,13,3889
0,0,8,0,0,1,9,3892
2,2,6,2,0,7,19,3893
1,0,9,3,0,0,13,3894
0,0,7,1,0,5,13,3895
1,0,9,1,0,4,15,3896
0,0,8,0,0,0,8,3897
4,2,5,2,3,4,20,3899
3,1,7,1,3,4,19,3900
5,2,9,3,0,4,23,3901
1,1,14,1,0,1,18,3903
2,0,7,2,0,7,18,3904
1,0,12,0,0,2,15,3905
3,0,8,1,0,3,15,3906
1,0,5,1,0,1,8,3907
1,0,11,0,0,3,15,3908
5,2,9,3,0,4,23,3911
1,0,11,0,0,3,15,3913
5,2,9,3,0,4,23,3914
1,0,11,0,0,3,15,3916
0,1,2,1,0,1,5,3917
1,0,11,0,0,3,15,3919
2,2,12,3,1,4,24,3921
0,0,10,0,0,1,11,3922
5,3,4,0,0,3,15,3923
3,1,6,1,1,3,15,3924
5,1,6,2,0,2,16,3926
1,0,1,0,0,0,2,3927
2,1,4,0,1,2,10,3932
1,0,11,0,0,2,14,3933
2,0,5,0,0,2,9,3935
3,2,8,0,3,4,20,3936
1,0,5,0,0,1,7,3937
1,0,1,1,0,1,4,3938
1,0,1,1,0,0,3,3940
2,0,3,4,0,2,11,3944
4,1,10,1,1,5,22,3945
1,0,11,0,0,3,15,3947
3,1,2,0,0,3,9,3948
7,2,4,3,3,5,24,3949
3,0,6,3,0,6,18,3950
3,0,7,0,1,7,18,3951
1,0,11,0,1,6,19,3952
1,1,11,1,0,6,20,3953
1,0,10,3,0,8,22,3954
1,0,11,0,1,6,19,3955
1,0,11,0,1,6,19,3956
1,0,4,1,3,1,10,3957
1,0,10,0,1,6,18,3958
5,4,6,0,2,5,22,3959
1,0,11,0,1,6,19,3960
0,0,13,2,0,4,19,3961
1,0,11,0,1,6,19,3962
1,0,7,0,0,2,10,3964
2,0,11,0,1,8,22,3967
1,0,11,0,1,6,19,3968
3,1,7,1,1,4,17,3969
4,0,8,1,1,5,19,3970
3,2,7,1,0,9,22,3973
1,2,2,0,0,2,7,3975
1,0,11,0,1,6,19,3977
0,0,8,1,0,1,10,3979
2,0,11,0,0,4,17,3980
1,0,11,0,1,6,19,3982
1,0,11,0,1,6,19,3983
3,3,6,0,0,7,19,3984
2,0,6,2,3,2,15,3989
4,1,6,2,0,4,17,3990
1,0,11,0,1,6,19,3992
0,0,8,3,0,8,19,3993
3,2,6,1,0,6,18,3994
3,0,6,0,0,4,13,3995
1,0,9,4,3,7,24,3996
0,0,7,0,1,1,9,3997
2,2,2,1,0,2,9,3998
0,0,5,1,1,1,8,4000
0,0,3,0,0,1,4,4003
3,3,4,2,1,9,22,4005
3,0,6,5,1,8,23,4006
1,0,6,3,0,1,11,4008
5,1,10,2,1,7,26,4010
2,0,6,2,0,0,10,4011
0,0,2,1,0,0,3,4012
2,1,3,1,0,1,8,4014
1,0,3,0,0,1,5,4017
7,3,4,2,2,11,29,4018
0,1,12,0,0,4,17,4019
2,0,12,1,1,4,20,4020
1,0,8,1,0,1,11,4021
1,0,8,1,0,4,14,4022
1,0,11,0,0,5,17,4024
0,0,8,0,0,2,10,4025
0,0,9,2,0,3,14,4026
1,1,7,2,0,2,13,4027
2,1,3,1,0,2,9,4028
1,1,2,0,0,2,6,4029
2,1,10,2,1,8,24,4030
2,0,14,3,0,1,20,4032
3,1,4,0,0,1,9,4033
2,0,8,1,0,1,12,4034
5,2,5,2,2,10,26,4038
1,0,7,0,0,2,10,4039
3,0,9,4,0,8,24,4041
5,5,7,0,1,10,28,4042
1,0,13,0,0,1,15,4043
2,0,6,1,0,3,12,4044
5,2,4,1,4,8,24,4045
0,0,10,1,0,4,15,4046
2,1,5,2,0,5,15,4047
2,0,11,0,0,4,17,4049
3,0,9,0,0,10,22,4050
2,0,10,0,0,3,15,4051
1,0,6,3,0,5,15,4052
2,0,8,1,0,3,14,4054
3,3,9,2,2,6,25,4055
9,0,6,1,0,9,25,4057
1,0,12,2,0,3,18,4058
4,0,6,4,3,4,21,4060
5,1,7,2,0,8,23,4061
0,0,10,0,0,0,10,4062
1,0,6,2,0,5,14,4063
9,0,6,1,0,9,25,4064
0,0,6,2,0,9,17,4065
2,0,10,0,0,3,15,4068
2,0,10,0,0,3,15,4072
2,0,10,0,0,3,15,4076
2,0,10,0,0,3,15,4077
1,0,5,0,0,2,8,4078
3,0,6,1,0,1,11,4079
1,0,12,2,0,3,18,4080
2,0,11,0,0,4,17,4081
0,0,7,1,0,1,9,4083
0,0,11,0,0,1,12,4084
4,1,2,0,1,6,14,4085
2,0,11,0,0,4,17,4086
1,0,6,0,0,2,9,4087
3,0,5,1,0,6,15,4088
6,1,8,1,0,7,23,4089
2,0,8,0,0,3,13,4091
1,0,12,2,0,3,18,4092
3,0,5,1,0,4,13,4093
1,0,7,3,0,1,12,4094
4,2,5,1,0,5,17,4095
3,0,10,0,0,4,17,4096
2,0,5,1,0,6,14,4097
0,0,14,2,0,6,22,4098
0,0,6,0,0,1,7,4100
0,0,6,0,0,0,6,4101
4,3,5,1,0,4,17,4103
3,0,14,1,0,5,23,4104
0,0,7,0,0,1,8,4105
1,0,5,2,0,4,12,4107
2,0,8,0,0,1,11,4108
1,0,6,0,0,1,8,4111
4,1,10,4,2,5,26,4112
2,0,5,0,0,1,8,4113
2,0,12,1,1,3,19,4114
4,1,6,2,0,6,19,4116
4,3,3,2,1,5,18,4117
2,0,4,0,1,2,9,4119
5,0,6,1,5,4,21,4121
3,0,8,1,0,1,13,4122
2,0,8,2,0,5,17,4123
1,1,4,3,1,3,13,4124
1,1,3,0,2,1,8,4127
0,0,3,0,0,1,4,4128
5,3,8,2,0,8,26,4129
2,3,3,1,0,8,17,4131
2,0,7,1,1,6,17,4132
4,1,11,2,0,10,28,4133
2,0,7,2,0,2,13,4135
1,0,6,3,1,1,12,4138
3,0,8,1,1,1,14,4139
2,1,3,0,0,1,7,4140
3,3,3,1,0,1,11,4141
4,2,8,0,1,3,18,4142
0,0,6,0,0,3,9,4143
3,0,13,1,0,5,22,4145
1,2,7,3,0,6,19,4146
4,2,5,1,1,5,18,4147
8,3,5,2,1,7,26,4149
4,4,5,1,2,5,21,4150
4,5,4,3,0,4,20,4152
2,3,3,0,0,2,10,4153
4,5,4,0,1,10,24,4154
2,0,6,1,0,2,11,4156
3,1,4,2,1,3,14,4157
2,0,1,0,0,0,3,4158
5,4,2,1,0,4,16,4159
3,2,1,1,2,0,9,4160
4,5,2,0,0,4,15,4161
3,3,2,1,0,2,11,4163
2,2,1,1,1,1,8,4164
0,1,4,1,0,2,8,4166
4,4,4,0,0,7,19,4167
2,2,2,2,0,2,10,4168
5,1,8,3,0,5,22,4170
2,2,1,0,0,0,5,4171
3,3,1,1,0,2,10,4172
1,1,4,1,0,2,9,4173
2,1,3,0,0,2,8,4175
5,1,5,3,0,9,23,4176
3,3,2,1,1,3,13,4177
2,2,2,1,0,4,11,4178
6,5,5,2,2,5,25,4180
4,3,6,0,3,8,24,4181
3,2,5,1,0,6,17,4182
5,3,6,2,2,6,24,4183
4,1,10,1,0,7,23,4184
2,0,8,1,0,3,14,4189
2,1,3,2,0,2,10,4191
2,6,4,1,2,8,23,4197
4,4,4,2,2,5,21,4198
7,5,9,0,1,2,24,4199
1,1,2,0,1,2,7,4200
3,0,4,1,0,2,10,4201
4,4,5,2,1,9,25,4202
2,1,4,1,0,3,11,4203
3,1,9,0,1,2,16,4204
0,0,3,1,0,2,6,4205
2,1,7,0,0,3,13,4206
5,2,7,1,2,8,25,4209
2,1,9,1,1,3,17,4210
4,0,8,2,0,3,17,4211
4,0,4,2,0,3,13,4212
5,3,7,3,1,4,23,4213
4,1,3,1,0,5,14,4214
3,1,9,0,1,2,16,4216
2,0,6,0,0,3,11,4218
2,1,1,1,2,0,7,4219
1,0,6,1,0,2,10,4220
2,0,4,2,1,5,14,4221
2,2,3,0,2,0,9,4224
3,1,5,1,0,3,13,4225
5,4,4,2,4,7,26,4227
3,1,4,0,1,2,11,4230
5,6,2,2,4,5,24,4232
3,0,4,0,1,2,10,4233
2,0,7,0,0,2,11,4235
2,1,4,0,0,4,11,4237
3,0,5,1,1,7,17,4238
3,2,5,4,2,2,18,4239
4,2,7,2,0,8,23,4240
3,0,4,1,0,2,10,4241
3,2,3,2,2,3,15,4242
4,1,10,1,0,6,22,4243
0,0,4,0,0,0,4,4244
2,1,10,0,1,4,18,4245
5,1,7,0,0,5,18,4246
3,3,7,1,0,2,16,4247
1,1,1,0,1,1,5,4248
2,0,14,0,0,2,18,4250
2,0,14,0,0,2,18,4251
4,2,8,2,3,6,25,4252
0,0,9,0,0,0,9,4253
2,0,10,2,1,4,19,4255
3,1,4,1,0,3,12,4256
7,6,3,0,3,6,25,4257
1,0,1,1,0,2,5,4260
2,0,14,0,0,2,18,4261
0,0,4,1,0,1,6,4262
2,1,6,2,1,2,14,4264
2,1,1,0,0,1,5,4265
2,2,3,1,0,5,13,4266
4,1,4,0,0,3,12,4268
3,2,2,1,0,2,10,4269
3,2,4,1,3,3,16,4270
2,0,4,0,0,3,9,4271
1,0,8,1,0,4,14,4272
6,2,3,1,6,1,19,4273
4,1,6,3,0,7,21,4274
1,1,5,1,0,3,11,4275
3,0,8,1,1,5,18,4276
2,1,2,0,0,3,8,4279
2,0,14,0,0,2,18,4281
4,1,8,2,1,6,22,4282
1,0,3,0,0,1,5,4284
6,2,6,1,2,7,24,4288
5,4,6,2,0,9,26,4289
1,0,2,0,0,1,4,4292
1,1,9,1,0,2,14,4293
3,0,8,0,3,4,18,4295
2,2,2,1,0,2,9,4296
5,0,5,0,1,3,14,4297
2,1,14,2,3,7,29,4298
3,0,7,3,0,4,17,4299
1,0,9,0,0,2,12,4300
0,0,10,0,0,4,14,4301
1,0,9,0,0,2,12,4303
3,1,11,1,0,4,20,4304
2,1,8,1,0,7,19,4305
1,0,9,0,0,2,12,4306
1,0,3,0,0,3,7,4307
0,0,7,0,0,4,11,4309
3,2,6,2,0,4,17,4312
5,4,7,2,3,5,26,4313
1,0,6,3,0,1,11,4314
3,0,8,1,1,6,19,4317
3,0,7,3,0,4,17,4318
0,1,7,2,1,9,20,4320
1,0,5,2,0,3,11,4321
0,0,3,0,0,1,4,4322
0,0,11,1,0,2,14,4323
4,5,6,1,2,10,28,4324
0,0,14,1,0,2,17,4325
2,1,8,2,0,5,18,4326
2,1,10,1,0,4,18,4327
4,0,11,0,0,7,22,4328
1,0,2,1,1,2,7,4329
2,3,9,0,1,7,22,4330
2,0,11,2,0,6,21,4332
0,0,7,1,0,1,9,4333
2,2,7,3,0,5,19,4334
2,0,11,2,0,7,22,4335
5,0,6,0,2,9,22,4336
0,0,11,1,0,2,14,4337
5,1,4,0,4,10,24,4341
1,0,8,0,0,6,15,4342
3,1,11,1,0,4,20,4343
0,0,12,1,0,2,15,4345
1,0,6,4,0,10,21,4348
1,0,9,0,0,4,14,4349
1,0,10,0,0,2,13,4350
4,0,13,2,0,2,21,4351
2,0,7,1,1,5,16,4352
1,0,9,1,0,4,15,4353
1,0,8,4,0,8,21,4354
1,0,4,1,0,2,8,4355
1,0,4,2,2,6,15,4356
0,0,15,1,0,3,19,4357
0,0,9,4,0,9,22,4358
1,0,7,1,0,5,14,4359
3,0,14,1,0,4,22,4361
0,0,8,4,0,8,20,4362
0,0,10,0,0,5,15,4363
0,0,9,4,0,9,22,4365
2,1,6,4,0,7,20,4366
1,0,7,0,0,4,12,4368
2,0,3,0,0,1,6,4372
2,0,7,2,0,9,20,4373
3,0,5,1,0,1,10,4374
4,0,4,4,1,4,17,4375
0,0,10,3,0,9,22,4376
1,0,8,3,0,9,21,4377
2,0,9,0,0,5,16,4378
0,0,8,2,0,10,20,4379
0,0,8,1,0,4,13,4381
1,0,2,0,0,0,3,4382
2,0,4,4,1,6,17,4383
0,0,9,4,0,10,23,4384
0,0,7,4,0,12,23,4385
1,0,1,0,0,0,2,4387
1,1,11,1,0,6,20,4388
1,0,1,0,0,0,2,4391
0,0,12,0,0,1,13,4392
2,0,5,3,0,4,14,4393
3,0,7,0,2,6,18,4395
0,0,12,2,0,10,24,4396
7,0,2,0,0,5,14,4397
1,0,1,0,2,0,4,4398
3,2,3,1,0,0,9,4401
4,3,9,1,2,7,26,4402
2,1,3,0,0,2,8,4403
5,5,6,0,0,5,21,4405
6,4,5,1,1,4,21,4406
6,0,9,1,0,4,20,4407
3,0,5,0,1,0,9,4408
0,1,1,0,0,0,2,4410
1,1,1,0,0,0,3,4411
2,3,2,0,2,1,10,4412
0,0,5,0,0,1,6,4413
2,1,6,0,1,1,11,4415
3,1,4,0,1,1,10,4416
1,0,6,1,0,2,10,4421
3,5,6,3,2,7,26,4423
3,2,2,0,0,2,9,4424
3,2,4,0,0,6,15,4425
8,5,2,0,1,7,23,4426
6,2,2,2,0,5,17,4427
4,3,4,0,0,4,15,4428
2,1,1,0,0,0,4,4430
4,1,6,3,0,4,18,4432
2,1,1,0,0,2,6,4435
6,3,6,0,2,8,25,4436
3,3,7,1,1,2,17,4437
3,2,11,0,0,6,22,4438
3,3,7,1,1,2,17,4440
5,5,5,1,1,8,25,4441
2,1,1,0,0,4,8,4442
3,3,5,0,1,7,19,4444
0,1,11,0,0,1,13,4445
4,2,3,2,1,2,14,4448
3,1,8,2,0,2,16,4449
3,2,6,2,2,6,21,4450
5,1,1,1,0,2,10,4451
6,7,7,1,2,4,27,4452
4,2,2,0,0,2,10,4454
7,3,5,2,1,6,24,4455
1,0,5,0,0,0,6,4456
3,1,7,0,1,7,19,4457
3,1,4,0,0,1,9,4458
1,0,5,0,1,2,9,4459
1,0,6,1,0,3,11,4463
3,1,3,1,1,1,10,4464
3,2,5,1,0,5,16,4465
6,1,5,2,2,7,23,4466
3,1,5,2,1,4,16,4468
2,0,7,3,0,0,12,4470
6,3,6,1,3,6,25,4471
4,0,9,0,0,5,18,4472
7,6,6,0,2,7,28,4476
5,1,6,3,1,5,21,4478
5,2,5,0,1,5,18,4479
3,3,2,0,2,1,11,4480
6,5,7,0,0,5,23,4482
4,2,2,2,2,3,15,4486
2,0,10,0,0,6,18,4487
2,1,10,2,0,2,17,4488
2,3,1,0,0,0,6,4489
3,0,8,3,1,5,20,4490
4,2,11,2,0,5,24,4491
5,0,5,2,0,5,17,4492
6,2,5,0,0,9,22,4493
4,0,3,1,1,4,13,4494
1,0,5,0,0,2,8,4496
3,0,5,2,1,7,18,4498
0,0,17,1,0,1,19,4499
1,0,5,1,0,0,7,4503
0,0,6,1,0,3,10,4504
0,0,17,1,0,1,19,4507
0,0,2,0,0,0,2,4508
1,0,16,0,0,0,17,4509
4,2,6,1,0,4,17,4511
3,0,11,0,0,1,15,4514
3,2,7,1,0,4,17,4515
0,0,10,1,0,3,14,4516
1,0,9,0,0,5,15,4517
3,3,8,0,0,4,18,4518
0,0,12,0,0,1,13,4519
4,1,9,3,3,8,28,4520
0,0,16,0,0,2,18,4521
3,1,10,1,0,6,21,4522
0,0,15,2,0,2,19,4523
1,0,3,2,0,0,6,4524
3,0,3,2,2,5,15,4525
0,0,11,0,0,2,13,4526
0,0,14,0,0,0,14,4527
4,1,7,1,2,9,24,4528
2,0,8,2,0,5,17,4529
2,0,9,3,1,9,24,4530
1,0,11,2,0,2,16,4531
0,0,4,1,0,4,9,4533
0,0,8,1,0,2,11,4534
3,0,14,0,0,1,18,4537
1,0,12,0,0,3,16,4538
1,0,16,1,1,2,21,4539
4,1,8,2,0,3,18,4541
2,0,9,0,1,8,20,4542
3,0,8,1,1,7,20,4543
3,3,6,0,3,4,19,4544
0,0,15,1,0,4,20,4546
3,2,7,2,1,3,18,4547
1,0,2,2,0,1,6,4548
4,2,9,0,0,9,24,4549
2,0,8,2,0,4,16,4550
5,4,5,1,1,5,21,4551
2,0,10,0,0,6,18,4553
4,1,7,1,0,3,16,4556
1,1,9,1,1,4,17,4557
2,1,6,1,0,1,11,4561
1,0,6,4,0,1,12,4562
0,0,7,0,0,1,8,4563
2,0,14,3,0,5,24,4564
3,3,7,0,1,4,18,4565
3,0,6,1,0,1,11,4567
6,0,8,0,0,4,18,4568
0,0,9,0,0,2,11,4569
2,0,5,1,0,0,8,4571
0,1,7,0,0,3,11,4573
4,1,7,2,0,1,15,4575
5,1,13,3,0,4,26,4576
0,0,9,1,0,2,12,4577
1,1,5,1,0,2,10,4578
3,2,7,0,0,5,17,4579
3,1,8,2,1,6,21,4580
4,2,7,1,0,11,25,4582
2,1,10,0,0,4,17,4584
2,0,11,0,1,3,17,4585
4,0,6,4,0,2,16,4587
4,1,9,4,0,2,20,4588
2,1,12,0,0,3,18,4589
4,0,11,3,0,5,23,4590
1,0,7,1,1,2,12,4592
1,0,9,1,1,2,14,4593
2,0,7,0,0,1,10,4595
0,0,10,0,0,4,14,4596
0,0,7,0,2,7,16,4597
1,2,10,3,1,4,21,4598
4,0,9,0,1,7,21,4599
3,2,3,0,2,4,14,4600
4,1,9,1,1,2,18,4601
0,0,10,0,0,1,11,4602
2,0,14,0,0,2,18,4604
4,3,6,2,1,8,24,4606
0,0,9,0,0,2,11,4607
4,0,13,0,0,3,20,4608
3,1,10,2,1,1,18,4609
1,0,11,3,0,4,19,4610
2,0,5,1,0,4,12,4611
1,0,10,0,0,1,12,4614
0,0,10,1,0,5,16,4616
1,0,14,0,2,5,22,4617
4,1,7,1,0,2,15,4619
1,0,12,1,0,5,19,4620
3,1,9,1,1,3,18,4622
3,0,7,0,0,4,14,4624
2,1,11,1,0,7,22,4625
0,0,5,0,0,0,5,4627
0,0,11,2,0,3,16,4628
2,2,8,1,2,4,19,4630
4,0,9,2,0,4,19,4631
4,2,12,0,0,3,21,4632
3,1,9,1,1,2,17,4634
0,0,13,0,0,1,14,4635
4,1,7,1,0,2,15,4637
1,1,7,2,0,9,20,4639
2,0,8,3,1,6,20,4641
4,4,8,2,0,4,22,4642
2,1,8,1,0,5,17,4644
0,0,13,0,0,2,15,4646
3,1,3,0,1,5,13,4649
3,0,9,0,0,2,14,4650
3,0,9,0,0,2,14,4655
4,2,9,1,0,8,24,4656
2,0,10,0,1,9,22,4657
3,0,9,0,0,2,14,4658
4,2,9,1,0,8,24,4659
4,0,9,4,0,3,20,4661
4,2,3,3,1,6,19,4664
3,0,4,0,0,3,10,4666
3,0,8,1,0,1,13,4667
4,2,9,1,0,8,24,4669
3,1,4,1,1,2,12,4670
3,0,9,0,0,2,14,4671
4,2,9,1,0,8,24,4672
2,0,2,0,0,2,6,4673
3,1,4,1,0,3,12,4674
2,5,2,0,1,2,12,4675
1,1,4,0,0,2,8,4677
4,0,9,0,0,8,21,4678
5,2,8,0,0,6,21,4679
3,1,4,1,1,2,12,4680
6,2,3,2,1,8,22,4681
0,0,8,0,1,0,9,4682
4,2,9,1,0,8,24,4684
6,2,3,3,1,7,22,4687
2,0,8,0,1,4,15,4688
1,0,9,0,0,3,13,4689
3,1,4,1,0,3,12,4690
4,2,9,1,0,8,24,4691
3,0,9,0,0,2,14,4692
3,0,9,0,0,2,14,4693
3,0,9,0,0,2,14,4694
3,1,4,1,1,2,12,4695
2,0,11,1,0,4,18,4696
1,0,11,1,1,6,20,4697
1,0,5,2,2,7,17,4698
2,0,7,1,1,6,17,4699
1,1,7,0,0,3,12,4700
2,2,4,0,0,5,13,4702
0,0,6,0,0,2,8,4703
2,0,6,2,0,4,14,4704
4,1,6,0,0,4,15,4705
2,0,7,3,0,4,16,4706
0,0,5,0,0,3,8,4707
2,0,6,1,1,7,17,4708
1,0,5,1,0,1,8,4709
2,0,11,1,1,7,22,4710
6,3,4,3,2,9,27,4711
6,2,8,1,0,7,24,4712
2,1,12,0,0,7,22,4713
4,0,10,0,0,5,19,4714
5,4,5,1,2,11,28,4715
6,1,6,0,1,8,22,4716
5,0,7,0,0,6,18,4717
2,1,4,0,1,5,13,4719
1,0,6,0,0,1,8,4720
3,3,3,0,0,7,16,4722
4,0,9,0,0,6,19,4723
1,0,6,0,0,2,9,4724
4,2,4,3,0,3,16,4725
5,3,6,0,1,9,24,4726
1,0,3,1,0,2,7,4729
1,0,5,0,0,1,7,4730
1,0,4,3,2,2,12,4731
4,2,6,0,0,6,18,4732
3,2,5,0,2,3,15,4734
4,1,6,2,0,2,15,4735
4,4,10,0,1,7,26,4736
4,0,5,1,1,3,14,4737
3,1,3,1,1,5,14,4738
4,0,9,0,1,6,20,4739
1,0,9,0,0,0,10,4740
6,1,6,0,0,8,21,4742
5,3,8,0,0,8,24,4744
4,0,6,1,0,4,15,4745
7,3,3,2,2,9,26,4747
1,1,2,0,0,3,7,4748
3,0,4,0,0,2,9,4749
3,2,5,2,0,6,18,4750
3,0,6,2,1,5,17,4752
5,2,4,2,5,5,23,4753
0,1,2,0,0,1,4,4754
6,1,5,1,2,6,21,4755
9,3,3,0,1,5,21,4757
0,0,9,0,0,1,10,4758
2,0,11,0,0,2,15,4759
2,2,5,2,3,6,20,4760
3,0,5,1,0,2,11,4762
2,0,9,2,0,2,15,4765
3,0,8,0,2,2,15,4766
3,0,8,2,0,7,20,4768
2,0,10,0,0,6,18,4769
1,1,2,0,0,1,5,4770
2,0,6,1,0,4,13,4771
3,0,11,2,0,1,17,4773
4,0,6,0,0,3,13,4774
2,0,10,2,0,1,15,4775
2,0,10,1,0,4,17,4777
3,0,13,2,0,2,20,4778
2,0,4,2,0,5,13,4779
7,1,7,1,1,8,25,4782
3,0,5,1,1,6,16,4783
3,1,12,0,0,4,20,4784
3,0,9,0,0,6,18,4785
0,0,14,0,0,1,15,4786
2,0,9,2,0,1,14,4787
1,0,7,1,0,3,12,4788
1,1,5,2,0,4,13,4789
3,0,9,3,0,1,16,4790
1,0,5,1,1,2,10,4791
1,0,6,0,0,3,10,4793
8,2,4,3,1,5,23,4794
1,0,7,0,0,2,10,4795
0,0,3,0,0,0,3,4797
2,2,10,0,0,6,20,4798
1,0,6,0,0,3,10,4799
1,0,9,1,0,2,13,4800
2,0,4,2,2,5,15,4802
6,1,6,0,1,7,21,4803
2,0,10,1,0,4,17,4807
3,2,5,0,0,4,14,4808
5,0,11,0,0,7,23,4809
2,0,5,0,0,3,10,4810
5,0,8,2,0,5,20,4812
2,0,9,2,0,7,20,4813
1,0,7,0,0,3,11,4814
1,0,5,1,0,2,9,4819
2,0,11,1,0,6,20,4820
1,0,6,0,0,2,9,4821
0,0,10,0,0,1,11,4823
1,0,7,2,0,1,11,4825
2,1,10,1,0,5,19,4826
5,0,10,1,1,6,23,4828
2,0,12,0,0,1,15,4829
3,0,10,1,0,3,17,4830
5,2,8,3,1,8,27,4831
3,0,10,0,0,4,17,4832
1,0,8,1,0,0,10,4833
4,0,11,0,0,4,19,4834
4,3,7,2,0,5,21,4835
3,2,6,1,1,3,16,4836
1,0,10,3,0,2,16,4840
2,0,10,1,1,6,20,4842
4,0,7,1,1,5,18,4843
4,1,8,2,0,3,18,4844
4,3,5,1,2,4,19,4845
1,0,7,1,0,5,14,4846
0,0,10,0,0,2,12,4847
6,0,12,3,0,5,26,4848
1,0,8,1,0,3,13,4849
1,0,6,0,0,2,9,4850
1,0,11,2,1,7,22,4852
2,0,10,0,0,6,18,4853
1,0,7,0,0,0,8,4854
5,0,6,1,2,6,20,4856
3,3,5,1,3,6,21,4857
3,0,8,2,1,5,19,4858
2,0,8,0,0,2,12,4859
0,0,9,1,0,1,11,4860
3,1,2,1,1,2,10,4864
3,1,12,1,1,6,24,4866
2,2,3,2,1,2,12,4867
2,4,7,2,0,4,19,4868
1,0,5,0,0,1,7,4869
5,2,7,2,1,7,24,4870
4,2,5,2,0,4,17,4872
6,1,6,1,0,7,21,4874
2,0,4,0,0,4,10,4875
3,2,3,1,1,9,19,4876
5,1,8,0,1,8,23,4877
3,2,3,0,0,5,13,4878
3,2,7,0,0,3,15,4879
3,1,2,0,0,3,9,4881
0,0,12,0,0,3,15,4882
1,1,3,0,0,2,7,4883
4,1,7,0,0,6,18,4884
3,1,12,1,1,6,24,4887
2,0,14,1,0,6,23,4888
3,0,9,0,0,3,15,4889
1,0,1,0,0,2,4,4890
3,1,12,1,1,6,24,4891
0,1,3,0,1,0,5,4892
2,1,5,0,1,2,11,4893
4,3,7,1,0,9,24,4894
1,1,3,1,0,2,8,4895
7,3,5,0,0,5,20,4896
1,1,9,0,1,1,13,4897
2,0,11,4,1,2,20,4898
3,1,12,1,1,6,24,4899
3,2,2,2,0,5,14,4900
1,0,1,0,0,2,4,4901
3,1,12,1,1,6,24,4903
3,3,4,0,1,2,13,4905
1,1,2,1,0,0,5,4906
1,0,2,1,0,1,5,4908
1,2,3,1,0,4,11,4909
4,1,6,1,1,7,20,4910
3,2,5,0,0,3,13,4911
4,2,7,1,2,7,23,4912
3,1,10,2,1,5,22,4913
3,0,10,1,0,5,19,4914
2,2,1,0,1,0,6,4915
1,2,9,1,0,5,18,4917
0,0,7,0,0,3,10,4918
2,0,10,1,0,8,21,4919
10,3,4,1,1,10,29,4920
0,0,7,0,0,3,10,4922
1,1,3,3,1,1,10,4923
2,0,7,2,0,7,18,4924
2,0,7,0,1,4,14,4926
6,4,7,1,0,9,27,4929
4,0,6,1,1,9,21,4931
5,3,4,1,3,6,22,4934
0,0,7,0,0,3,10,4935
2,1,3,1,0,1,8,4936
1,0,4,1,0,0,6,4938
1,1,4,1,1,0,8,4940
3,2,5,0,2,4,16,4943
4,2,3,0,2,3,14,4944
4,0,9,2,2,7,24,4945
4,0,7,3,2,7,23,4946
2,1,1,1,0,0,5,4948
4,1,9,1,0,9,24,4951
4,0,6,1,1,9,21,4952
7,2,4,1,3,4,21,4953
1,0,3,0,1,3,8,4954
1,0,8,1,0,1,11,4955
4,0,8,1,0,3,16,4957
8,2,7,2,1,4,24,4958
3,1,8,4,0,8,24,4959
0,0,15,0,0,2,17,4961
2,0,10,0,0,3,15,4962
1,1,11,0,0,5,18,4964
2,0,7,0,0,2,11,4966
2,0,9,1,0,6,18,4967
0,0,5,2,0,5,12,4968
1,1,8,1,0,4,15,4969
0,0,8,3,0,1,12,4970
2,0,4,2,2,4,14,4971
4,0,20,1,0,8,33,4972
0,0,14,0,0,0,14,4973
1,0,10,0,0,4,15,4974
1,0,12,2,0,2,17,4975
0,0,9,1,0,5,15,4978
2,0,4,2,1,3,12,4979
1,0,12,0,0,2,15,4980
0,1,9,3,0,5,18,4981
4,4,2,0,1,3,14,4982
0,0,9,0,0,8,17,4983
2,0,6,3,3,2,16,4984
1,0,3,1,1,2,8,4985
0,0,15,0,0,2,17,4986
1,0,9,0,0,2,12,4988
1,0,7,3,0,0,11,4989
1,0,6,4,0,1,12,4990
0,0,15,0,0,2,17,4992
0,0,15,0,0,2,17,4993
2,1,14,0,0,5,22,4995
0,0,3,0,0,0,3,4996
0,0,12,0,0,3,15,4997
1,2,4,1,0,2,10,4998
5,0,9,1,0,10,25,5000
1,0,7,0,0,7,15,5001
0,0,15,0,0,2,17,5002
2,1,12,0,0,5,20,5004
2,0,5,1,0,2,10,5005
3,2,9,0,0,5,19,5007
2,0,8,1,0,11,22,5008
4,0,8,0,0,7,19,5010
1,0,11,0,0,2,14,5013
1,1,3,0,0,1,6,5015
0,0,4,1,0,1,6,5016
2,1,12,0,0,3,18,5017
2,0,6,2,0,5,15,5018
2,0,11,1,0,2,16,5019
3,0,8,2,1,7,21,5022
1,0,6,1,0,6,14,5024
1,0,8,2,0,2,13,5025
3,0,12,0,0,3,18,5027
3,1,10,2,1,3,20,5028
2,1,11,2,0,6,22,5029
0,0,14,0,0,5,19,5032
0,0,11,0,0,1,12,5033
1,0,11,2,0,3,17,5034
1,0,7,0,0,2,10,5035
1,0,5,1,0,6,13,5037
2,0,10,0,0,2,14,5038
2,0,10,0,1,4,17,5039
2,0,7,1,1,3,14,5040
1,0,14,0,0,5,20,5041
1,1,10,1,0,3,16,5043
1,1,10,1,0,3,16,5044
2,1,12,1,0,4,20,5046
2,0,8,1,0,3,14,5047
0,0,6,1,0,1,8,5049
3,1,14,0,0,1,19,5050
2,0,7,2,1,8,20,5052
1,1,10,1,0,3,16,5055
2,1,11,0,0,3,17,5056
4,1,7,2,0,3,17,5059
7,2,9,0,0,7,25,5060
0,0,11,2,0,3,16,5061
2,0,2,1,1,1,7,5062
0,0,8,0,0,3,11,5063
1,0,14,1,0,2,18,5064
4,2,9,3,2,2,22,5065
5,2,8,2,1,7,25,5067
0,0,5,1,0,2,8,5068
0,0,9,3,0,3,15,5069
1,0,7,1,0,3,12,5071
5,1,11,4,1,2,24,5072
4,1,8,0,0,7,20,5073
4,0,12,0,0,4,20,5074
0,0,8,0,0,3,11,5075
1,0,10,2,1,4,18,5076
5,2,8,1,0,6,22,5078
2,0,4,0,0,3,9,5079
3,2,10,0,0,6,21,5080
1,0,7,1,0,3,12,5082
2,0,6,3,1,5,17,5083
2,0,7,4,0,3,16,5085
1,0,9,1,0,3,14,5087
0,0,11,0,0,3,14,5088
2,0,10,1,0,1,14,5089
3,0,8,3,0,3,17,5092
1,0,8,1,0,4,14,5094
5,0,6,3,0,10,24,5095
1,0,9,0,0,3,13,5096
1,0,2,4,0,3,10,5097
5,3,8,1,0,6,23,5098
0,0,11,3,1,4,19,5099
1,0,4,0,0,5,10,5101
2,0,7,0,0,3,12,5102
0,0,8,0,0,0,8,5103
2,0,6,1,0,1,10,5104
3,1,7,1,0,5,17,5105
3,2,10,1,0,7,23,5106
3,2,9,1,0,5,20,5107
1,1,8,0,0,2,12,5109
0,0,10,1,0,3,14,5110
3,0,8,3,0,8,22,5113
0,0,9,0,0,1,10,5114
3,0,8,0,0,8,19,5115
3,2,2,3,1,1,12,5116
1,0,6,3,0,3,13,5117
3,0,4,1,0,2,10,5119
1,0,3,0,0,2,6,5120
1,1,7,1,0,4,14,5122
2,0,5,2,0,3,12,5124
1,0,7,1,0,2,11,5125
0,0,4,1,1,1,7,5126
3,0,8,3,0,8,22,5127
1,0,5,1,0,4,11,5128
3,0,8,3,0,8,22,5130
2,0,5,2,0,3,12,5131
1,0,8,3,0,2,14,5132
0,0,7,0,0,4,11,5134
2,0,5,3,0,2,12,5135
2,0,9,0,0,2,13,5136
3,0,8,3,0,8,22,5137
1,0,8,2,0,3,14,5138
4,3,7,3,0,2,19,5139
3,0,8,3,0,8,22,5140
2,0,2,2,2,1,9,5141
3,0,4,1,0,2,10,5142
3,0,8,3,0,8,22,5144
3,0,8,3,0,8,22,5145
3,3,3,0,3,8,20,5146
2,0,6,0,0,4,12,5148
1,0,6,0,1,2,10,5149
0,0,1,1,0,0,2,5150
2,1,10,3,0,5,21,5152
3,0,8,3,0,8,22,5153
3,0,4,1,0,2,10,5154
1,0,3,2,0,4,10,5155
3,0,8,3,0,8,22,5157
3,0,8,3,0,8,22,5159
3,0,4,1,0,2,10,5160
1,0,7,2,1,5,16,5162
3,0,9,2,0,7,21,5164
1,3,7,1,0,6,18,5165
0,0,6,2,0,4,12,5166
4,4,7,1,2,6,24,5168
3,0,7,2,1,4,17,5169
4,1,6,2,0,5,18,5170
3,0,9,1,0,11,24,5171
2,0,8,3,0,12,25,5172
2,0,7,2,0,1,12,5174
1,0,4,3,0,0,8,5175
3,1,10,0,0,3,17,5176
1,0,12,2,0,4,19,5177
0,0,6,0,0,1,7,5178
1,0,3,1,0,0,5,5179
3,1,11,0,0,6,21,5180
3,0,7,2,0,1,13,5181
4,2,7,1,1,7,22,5182
1,0,2,3,1,1,8,5183
2,0,3,0,0,3,8,5184
3,1,7,2,0,4,17,5185
2,2,5,0,0,2,11,5186
3,0,3,0,0,1,7,5187
0,0,6,1,0,2,9,5188
2,1,5,3,0,4,15,5189
2,0,7,1,0,9,19,5190
2,0,8,2,0,4,16,5191
2,0,2,2,0,5,11,5192
2,1,13,2,0,1,19,5193
4,2,7,0,2,5,20,5194
2,1,2,1,0,1,7,5195
3,0,5,3,0,7,18,5196
3,1,7,5,2,5,23,5197
3,0,4,2,0,0,9,5198
2,1,11,1,0,2,17,5199
1,0,5,2,0,3,11,5200
3,0,7,2,0,3,15,5201
2,0,5,3,0,5,15,5202
3,0,8,1,0,6,18,5203
3,1,4,0,1,7,16,5204
3,0,10,3,0,6,22,5206
3,0,9,1,0,3,16,5207
4,0,9,3,0,4,20,5208
2,0,10,2,0,7,21,5209
1,0,6,2,0,5,14,5210
0,0,10,2,0,2,14,5211
3,1,1,1,3,0,9,5212
0,1,3,0,0,0,4,5213
4,2,9,2,0,5,22,5218
2,1,13,2,0,3,21,5219
1,0,6,1,0,1,9,5220
0,0,1,0,0,0,1,5221
1,0,7,0,1,2,11,5222
3,0,4,0,1,5,13,5223
0,0,1,0,0,0,1,5224
1,0,7,2,1,2,13,5226
4,2,6,2,1,6,21,5227
2,0,6,1,0,2,11,5228
0,0,2,0,0,0,2,5229
2,0,5,0,0,2,9,5230
2,0,7,2,0,2,13,5231
3,1,2,0,0,6,12,5232
2,1,2,0,0,2,7,5233
0,0,10,0,0,1,11,5234
0,0,2,0,1,1,4,5235
0,0,1,1,0,0,2,5236
0,0,13,5,0,8,26,5238
0,0,2,1,0,0,3,5242
1,0,8,1,0,0,10,5243
3,1,3,1,0,5,13,5244
0,0,1,1,0,0,2,5245
2,0,6,1,0,2,11,5247
0,0,2,0,0,0,2,5248
0,0,3,3,3,2,11,5249
2,1,13,2,0,3,21,5251
2,0,7,2,1,7,19,5252
0,0,3,2,4,2,11,5254
1,1,12,1,0,3,18,5255
2,1,13,2,0,5,23,5256
2,0,8,2,0,6,18,5257
0,0,1,0,0,0,1,5259
2,2,7,1,0,5,17,5260
0,0,5,0,0,1,6,5262
2,1,3,1,1,4,12,5263
3,2,9,2,0,4,20,5264
0,2,6,2,1,3,14,5265
7,5,6,2,0,9,29,5266
3,3,2,1,0,2,11,5267
5,4,2,0,1,4,16,5269
5,0,5,2,1,7,20,5270
2,1,7,1,1,4,16,5271
0,0,6,0,0,0,6,5272
6,2,6,3,2,7,26,5273
2,2,11,0,0,2,17,5274
5,5,6,1,1,6,24,5276
2,0,4,1,1,3,11,5278
0,0,3,0,0,0,3,5280
3,2,7,2,0,5,19,5281
3,1,8,3,0,9,24,5282
3,2,7,1,1,7,21,5283
4,3,9,1,0,7,24,5284
0,1,2,1,0,0,4,5285
2,0,7,1,0,2,12,5286
3,0,5,1,0,3,12,5287
3,2,4,1,0,7,17,5290
2,1,2,1,0,1,7,5291
2,1,3,0,0,2,8,5292
5,2,10,1,0,4,22,5293
3,2,4,0,2,4,15,5295
2,2,7,1,0,6,18,5296
3,4,2,2,1,3,15,5297
4,0,10,4,0,7,25,5298
2,0,3,0,0,3,8,5299
3,3,7,0,0,6,19,5300
2,0,4,0,0,7,13,5301
1,1,1,1,1,2,7,5302
2,0,8,1,0,11,22,5304
3,1,8,3,1,10,26,5305
3,0,7,2,3,3,18,5306
3,1,5,4,1,3,17,5308
1,1,2,0,0,0,4,5309
0,0,8,4,0,5,17,5310
0,0,12,0,0,2,14,5313
1,0,7,1,0,3,12,5315
2,0,11,0,0,8,21,5316
2,0,2,0,1,4,9,5317
7,2,9,0,1,7,26,5319
1,1,4,0,0,1,7,5320
0,0,5,2,0,1,8,5321
1,1,3,0,0,1,6,5322
3,1,4,0,1,2,11,5323
2,0,3,0,1,2,8,5324
2,0,1,2,1,3,9,5325
1,1,1,0,0,0,3,5326
1,0,5,0,0,7,13,5328
0,0,3,0,0,1,4,5330
2,0,14,1,0,7,24,5331
2,2,7,0,0,1,12,5332
4,2,8,3,1,3,21,5335
3,0,3,1,2,2,11,5336
3,0,3,1,2,0,9,5337
0,0,6,0,0,0,6,5338
1,1,2,0,1,2,7,5339
2,2,4,1,1,5,15,5341
2,0,13,1,0,7,23,5342
0,0,3,1,0,2,6,5343
1,0,5,0,0,0,6,5344
6,1,6,1,1,6,21,5345
4,1,6,1,0,4,16,5346
6,4,6,2,1,1,20,5347
3,1,4,0,2,5,15,5349
4,1,3,3,1,3,15,5350
2,1,2,0,0,2,7,5351
2,0,8,1,0,6,17,5352
1,1,5,1,1,4,13,5353
3,2,6,1,0,5,17,5354
0,0,3,0,0,1,4,5355
3,2,2,1,0,4,12,5356
6,1,3,1,0,4,15,5357
3,0,3,2,1,3,12,5359
0,0,16,0,0,3,19,5362
3,4,8,0,0,9,24,5365
1,0,12,0,0,3,16,5366
1,0,5,1,0,1,8,5367
3,0,10,1,0,13,27,5368
5,2,5,0,1,10,23,5371
0,0,15,1,0,3,19,5372
0,0,11,1,1,9,22,5373
2,0,8,1,0,1,12,5375
3,0,13,0,0,2,18,5377
1,1,4,0,1,1,8,5378
0,0,4,2,0,3,9,5379
3,1,8,3,1,11,27,5380
0,0,8,0,0,4,12,5381
3,0,11,1,0,5,20,5382
1,0,2,1,1,4,9,5383
5,6,5,2,3,8,29,5384
1,1,14,3,1,7,27,5385
5,0,11,2,0,9,27,5386
3,0,11,1,0,5,20,5387
1,0,14,3,1,5,24,5389
1,0,13,1,0,2,17,5391
0,0,12,0,0,0,12,5392
0,0,6,0,0,5,11,5396
1,0,5,0,0,0,6,5397
1,0,6,0,0,1,8,5400
2,0,12,1,0,3,18,5403
0,0,5,0,0,3,8,5404
1,0,4,0,0,1,6,5406
1,0,9,1,0,4,15,5407
3,0,8,0,0,1,12,5408
0,0,10,1,0,3,14,5409
0,0,8,0,0,3,11,5410
2,3,4,3,1,2,15,5411
2,2,9,1,2,3,19,5412
0,0,9,0,0,1,10,5413
0,0,13,0,0,4,17,5416
4,0,9,1,1,4,19,5417
3,0,7,5,2,3,20,5418
2,1,11,1,0,3,18,5420
6,4,7,3,0,6,26,5423
1,1,13,0,0,7,22,5425
3,3,7,2,1,7,23,5426
1,1,12,0,1,3,18,5428
2,1,6,1,1,3,14,5430
1,0,7,1,0,2,11,5432
4,1,5,2,3,5,20,5437
2,0,3,4,0,1,10,5439
0,2,6,2,3,7,20,5442
2,0,5,2,0,6,15,5443
1,0,7,0,0,2,10,5444
1,1,9,0,0,4,15,5445
1,0,8,1,0,4,14,5446
2,0,14,1,0,3,20,5448
2,0,6,3,0,3,14,5449
3,0,3,3,0,7,16,5450
1,0,7,2,0,1,11,5452
3,1,8,2,0,5,19,5454
2,0,9,2,0,5,18,5455
4,0,9,1,0,6,20,5458
4,0,8,2,0,6,20,5459
0,0,12,0,0,3,15,5460
0,0,13,1,0,4,18,5461
0,0,22,1,0,1,24,5462
0,0,22,1,0,1,24,5465
2,0,5,1,0,3,11,5466
1,0,3,0,0,1,5,5467
6,1,5,1,1,4,18,5468
4,0,8,0,2,8,22,5469
0,0,4,0,0,0,4,5471
1,1,7,0,0,1,10,5473
2,1,4,1,0,3,11,5475
0,1,5,0,0,2,8,5476
1,0,6,1,0,2,10,5477
4,1,5,2,1,3,16,5479
1,1,6,0,0,3,11,5480
0,0,22,1,0,1,24,5481
5,0,6,2,2,6,21,5482
5,0,8,0,0,6,19,5484
1,0,12,1,0,3,17,5485
5,1,10,3,0,4,23,5486
2,1,1,0,0,2,6,5487
3,1,5,1,0,8,18,5488
6,7,4,2,3,10,32,5489
5,0,9,0,0,6,20,5491
2,1,2,1,0,1,7,5492
6,3,5,2,0,9,25,5493
5,0,8,0,0,6,19,5494
2,3,8,0,1,5,19,5495
4,1,4,0,1,2,12,5496
5,1,5,2,3,2,18,5497
2,1,3,0,0,1,7,5498
4,4,3,1,0,6,18,5499
4,2,5,2,2,4,19,5501
3,1,7,0,2,6,19,5502
5,0,9,0,0,6,20,5503
5,0,8,0,0,6,19,5505
3,2,8,1,0,3,17,5506
1,1,9,1,0,4,16,5507
2,3,3,4,2,5,19,5509
0,0,7,1,0,3,11,5510
1,0,3,1,0,2,7,5514
4,1,5,1,0,6,17,5515
2,0,8,1,1,4,16,5517
1,0,4,0,0,0,5,5518
2,1,2,0,2,0,7,5519
2,0,2,0,2,1,7,5520
1,0,1,0,0,0,2,5521
3,2,7,3,2,6,23,5522
6,0,8,1,1,9,25,5524
2,0,2,1,1,2,8,5525
3,2,13,4,1,6,29,5526
7,4,7,0,1,5,24,5528
5,0,10,2,1,3,21,5529
5,0,6,1,1,3,16,5531
1,0,2,0,0,0,3,5532
2,0,6,1,0,2,11,5534
1,0,2,0,1,1,5,5535
5,0,10,1,0,5,21,5538
4,5,4,2,0,4,19,5539
2,0,3,2,1,2,10,5540
1,0,3,1,0,1,6,5541
7,7,3,1,0,5,23,5544
2,0,9,4,1,3,19,5545
7,3,5,1,0,6,22,5547
4,1,6,1,3,6,21,5548
2,0,14,1,0,2,19,5552
1,0,2,0,0,0,3,5553
2,0,3,0,0,1,6,5554
4,2,6,1,2,9,24,5555
1,0,13,0,0,3,17,5556
0,0,18,0,0,2,20,5557
2,2,4,2,2,5,17,5558
5,4,5,1,4,7,26,5559
0,0,18,0,0,2,20,5560
4,2,4,1,0,5,16,5561
0,0,13,0,0,1,14,5563
0,0,18,0,0,3,21,5564
0,0,18,0,0,3,21,5565
1,0,5,1,0,2,9,5567
2,0,8,0,0,4,14,5569
0,0,18,0,0,3,21,5570
7,5,4,1,2,7,26,5573
2,1,8,3,2,3,19,5575
2,1,5,3,0,3,14,5576
0,0,18,0,0,3,21,5577
0,1,2,0,0,1,4,5578
1,0,17,0,0,4,22,5579
0,0,18,0,0,3,21,5580
2,1,3,0,1,5,12,5581
1,0,19,0,0,4,24,5582
0,0,14,0,0,3,17,5584
0,0,17,0,0,3,20,5586
0,0,13,3,0,5,21,5587
0,0,18,0,0,3,21,5588
1,0,10,2,0,2,15,5589
0,0,14,0,0,3,17,5590
0,0,18,0,0,3,21,5592
0,0,9,0,0,5,14,5593
2,0,13,0,0,3,18,5594
0,0,18,0,0,3,21,5595
0,0,18,0,0,3,21,5598
0,0,18,0,0,3,21,5599
1,0,8,0,0,4,13,5600
6,4,7,0,1,6,24,5602
0,0,18,0,0,3,21,5603
0,0,11,0,1,3,15,5604
3,0,7,1,0,2,13,5605
1,0,12,0,0,10,23,5608
1,0,17,0,0,4,22,5609
3,0,16,1,0,4,24,5611
2,0,3,2,0,3,10,5612
1,0,6,0,0,4,11,5613
3,6,6,2,2,5,24,5614
0,0,11,1,0,4,16,5617
1,0,8,4,0,5,18,5618
4,0,7,2,0,2,15,5619
1,0,1,0,0,0,2,5620
2,0,4,1,0,4,11,5621
1,0,8,0,0,6,15,5622
1,0,7,0,0,6,14,5624
2,0,5,1,0,1,9,5625
1,0,8,3,0,5,17,5626
7,2,5,0,2,10,26,5627
2,0,3,2,0,3,10,5628
0,0,14,0,0,1,15,5629
6,4,5,0,1,6,22,5631
2,1,6,0,0,5,14,5632
1,0,6,2,0,1,10,5633
2,0,4,0,1,3,10,5634
2,0,14,0,0,3,19,5635
1,0,8,1,1,5,16,5638
0,0,4,0,0,3,7,5641
5,2,6,0,2,4,19,5642
1,1,9,1,1,7,20,5644
1,0,8,5,0,3,17,5645
0,0,11,0,0,3,14,5646
0,0,8,1,0,0,9,5647
0,0,17,0,0,1,18,5650
0,0,8,1,0,0,9,5651
2,0,8,1,0,3,14,5652
1,0,11,1,0,5,18,5653
3,3,7,1,1,3,18,5654
1,2,3,1,0,1,8,5655
0,0,9,0,0,2,11,5656
3,0,14,0,0,2,19,5657
4,0,7,2,1,9,23,5658
4,2,12,1,1,3,23,5659
1,0,13,0,0,1,15,5661
7,4,7,1,0,4,23,5662
2,0,11,1,0,4,18,5663
4,0,8,0,0,9,21,5664
4,1,11,2,1,6,25,5665
6,3,5,2,3,7,26,5668
2,2,2,1,1,4,12,5669
1,0,10,3,0,6,20,5670
3,3,8,0,0,5,19,5671
1,0,4,0,0,1,6,5672
4,4,9,1,0,8,26,5673
5,2,7,1,2,5,22,5674
2,0,13,1,0,3,19,5675
4,0,12,1,0,1,18,5676
1,0,12,1,0,8,22,5677
2,0,7,0,0,6,15,5680
3,3,6,0,1,5,18,5683
2,0,9,0,0,3,14,5684
2,2,8,3,0,8,23,5685
0,0,7,0,0,0,7,5686
3,4,4,2,0,4,17,5687
0,0,9,0,0,2,11,5688
2,0,10,3,0,4,19,5689
4,0,8,1,1,5,19,5690
1,0,5,1,1,3,11,5692
4,0,13,1,1,2,21,5693
2,3,6,1,0,6,18,5694
2,0,5,1,1,5,14,5695
4,3,7,1,0,6,21,5698
7,4,7,1,0,4,23,5699
1,0,6,0,0,3,10,5703
2,0,9,0,0,5,16,5704
0,0,2,0,1,0,3,5705
2,0,10,1,0,4,17,5706
5,0,8,1,3,3,20,5707
7,4,7,1,0,4,23,5710
0,0,19,0,0,3,22,5711
3,1,9,1,1,2,17,5712
1,1,7,2,1,8,20,5713
4,2,5,2,0,8,21,5714
1,1,2,2,0,0,6,5715
2,0,5,0,0,3,10,5716
0,0,10,1,0,5,16,5717
2,3,5,0,0,8,18,5719
1,0,2,0,0,3,6,5720
1,1,9,1,0,2,14,5721
1,0,9,2,0,7,19,5722
2,0,9,0,0,0,11,5724
2,0,5,0,0,3,10,5726
7,3,5,2,1,10,28,5727
6,3,14,3,0,11,37,5729
4,2,4,4,1,6,21,5730
4,1,12,0,1,6,24,5732
0,0,6,0,0,3,9,5733
4,2,5,2,0,8,21,5734
1,1,2,1,1,1,7,5736
4,0,9,1,0,4,18,5739
7,0,8,5,0,8,28,5740
4,1,6,2,2,10,25,5741
5,0,7,0,1,3,16,5743
2,0,3,3,0,5,13,5744
2,0,13,1,0,6,22,5745
2,1,5,2,1,3,14,5746
2,2,5,1,0,5,15,5748
3,1,7,3,0,6,20,5751
5,0,6,0,0,4,15,5752
2,0,10,1,0,1,14,5753
3,0,7,1,0,5,16,5754
0,0,7,0,0,1,8,5757
3,1,6,1,0,3,14,5758
4,0,10,1,2,2,19,5759
3,0,7,0,0,4,14,5760
2,0,8,1,0,3,14,5763
4,0,9,0,0,7,20,5764
2,1,8,0,0,4,15,5765
6,1,7,0,1,6,21,5766
2,0,9,1,0,3,15,5769
1,0,3,1,1,3,9,5771
1,0,13,1,0,2,17,5772
2,0,8,1,0,3,14,5775
0,0,5,2,2,2,11,5776
1,0,15,0,0,3,19,5777
3,1,5,1,1,4,15,5778
1,0,13,1,0,4,19,5780
2,0,17,0,0,0,19,5781
4,1,7,4,1,8,25,5783
4,0,12,1,0,1,18,5784
0,0,10,2,0,1,13,5789
0,0,5,0,0,2,7,5790
0,0,11,0,0,1,12,5791
2,2,2,2,0,2,10,5792
1,0,19,0,0,5,25,5793
0,0,6,1,0,4,11,5794
1,0,14,1,0,8,24,5795
0,0,22,0,0,5,27,5797
2,2,6,1,2,6,19,5798
0,0,4,0,0,3,7,5799
0,0,9,1,1,4,15,5800
3,1,5,1,0,4,14,5801
1,0,14,1,0,8,24,5803
2,1,7,0,0,4,14,5804
1,0,11,1,1,4,18,5805
4,0,11,1,0,7,23,5807
0,0,9,1,0,3,13,5808
6,4,6,0,3,5,24,5812
2,0,1,0,0,2,5,5814
3,0,9,0,1,6,19,5815
1,1,2,1,1,0,6,5816
0,0,6,1,0,0,7,5817
2,1,9,1,0,5,18,5818
0,0,3,1,0,1,5,5819
1,0,2,0,1,1,5,5821
3,1,8,1,1,1,15,5822
1,0,7,2,0,1,11,5824
3,0,9,0,1,6,19,5825
2,0,25,0,0,5,32,5826
2,0,10,2,0,5,19,5827
0,0,5,0,0,1,6,5828
2,0,4,1,0,3,10,5829
1,0,1,0,1,1,4,5832
2,0,9,2,2,6,21,5833
0,0,25,0,0,4,29,5834
2,0,3,3,2,2,12,5835
3,2,8,1,1,5,20,5836
0,0,5,0,0,0,5,5837
1,0,10,1,0,5,17,5840
3,2,12,0,1,4,22,5841
2,1,8,0,0,6,17,5842
1,0,7,1,0,4,13,5843
0,0,6,1,0,1,8,5845
2,0,5,2,1,2,12,5847
1,0,5,2,0,1,9,5848
0,0,6,1,0,2,9,5849
0,1,3,1,0,1,6,5850
6,2,3,0,0,6,17,5853
0,0,7,0,0,2,9,5854
1,0,8,0,0,2,11,5855
3,2,6,1,0,2,14,5856
1,0,12,2,2,0,17,5858
1,0,8,0,0,2,11,5861
3,1,8,0,4,8,24,5863
2,0,13,3,0,5,23,5864
0,1,2,1,0,0,4,5867
4,0,7,0,0,3,14,5868
3,2,4,2,1,4,16,5869
0,0,6,1,0,3,10,5870
4,1,0,0,0,0,5,5873
4,2,9,0,0,6,21,5874
1,0,7,1,0,4,13,5875
2,0,11,1,0,5,19,5876
1,0,6,3,0,2,12,5881
4,2,8,0,0,6,20,5882
2,0,10,1,0,3,16,5883
1,0,9,0,0,3,13,5884
2,0,13,1,1,0,17,5885
4,3,3,1,0,6,17,5886
2,2,4,0,1,4,13,5887
5,2,7,1,0,6,21,5888
1,0,4,0,0,1,6,5889
3,3,11,0,0,5,22,5890
0,0,15,0,0,0,15,5891
6,4,2,0,4,8,24,5892
5,2,6,2,1,9,25,5893
2,3,4,2,0,3,14,5894
0,0,11,0,0,0,11,5896
2,3,11,1,0,5,22,5898
4,3,8,4,0,7,26,5899
5,0,5,2,0,5,17,5900
3,0,6,2,0,2,13,5901
7,3,6,2,1,12,31,5902
5,9,5,0,4,4,27,5903
3,3,7,1,0,5,19,5904
6,5,9,1,1,7,29,5905
1,2,2,0,0,0,5,5906
2,2,8,2,1,7,22,5907
4,2,2,2,0,3,13,5908
3,1,4,3,1,2,14,5909
0,0,13,1,0,1,15,5911
0,0,6,0,0,1,7,5912
0,0,21,0,0,1,22,5913
2,1,11,1,1,0,16,5916
3,2,5,1,1,4,16,5918
1,0,4,0,0,1,6,5919
1,1,10,0,0,2,14,5920
3,3,11,0,0,5,22,5921
5,4,7,2,1,4,23,5922
5,4,7,2,3,7,28,5923
5,2,4,2,2,4,19,5925
5,2,5,5,2,9,28,5927
2,1,3,2,1,2,11,5928
1,0,4,1,1,0,7,5929
3,1,13,1,1,1,20,5930
6,4,6,4,1,3,24,5932
2,0,13,1,1,0,17,5933
6,2,4,3,0,2,17,5934
2,1,8,0,0,1,12,5935
3,2,12,4,0,1,22,5937
4,2,3,4,2,5,20,5938
1,0,7,0,0,1,9,5939
1,0,3,0,0,3,7,5942
1,0,2,0,0,1,4,5943
2,1,9,1,0,4,17,5944
1,0,9,1,1,1,13,5947
0,0,11,0,0,0,11,5949
4,0,10,3,1,6,24,5950
4,1,10,1,4,3,23,5952
0,0,12,0,0,3,15,5953
0,0,4,0,0,2,6,5954
1,0,7,0,0,7,15,5955
3,0,6,1,0,2,12,5956
1,2,5,1,2,4,15,5957
1,0,5,3,3,6,18,5958
1,0,7,0,0,1,9,5959
6,0,8,1,0,3,18,5960
5,1,13,0,1,5,25,5961
5,0,10,3,0,4,22,5962
0,0,10,2,0,4,16,5963
1,0,13,0,0,2,16,5964
0,0,8,1,0,5,14,5965
2,1,5,0,0,4,12,5966
2,0,4,1,0,1,8,5972
2,0,7,1,1,1,12,5974
0,0,11,0,0,5,16,5975
0,0,11,0,0,3,14,5978
5,1,9,1,0,6,22,5979
2,1,8,1,0,3,15,5980
2,1,6,2,1,2,14,5981
2,2,8,1,2,10,25,5982
0,0,10,0,0,5,15,5983
1,0,6,3,0,3,13,5985
6,1,8,2,1,6,24,5987
5,0,6,6,2,5,24,5988
0,0,7,0,0,0,7,5989
0,0,7,0,0,0,7,5990
1,0,7,2,0,2,12,5991
0,0,8,0,0,0,8,5992
2,0,5,1,1,2,11,5995
0,0,5,5,0,4,14,5996
3,0,7,1,0,5,16,5997
2,1,4,1,0,1,9,5998
5,0,2,2,2,5,16,5999
3,0,8,1,0,4,16,6000
1,0,4,1,1,1,8,6001
1,0,12,2,0,1,16,6002
0,0,8,0,0,0,8,6003
5,2,7,2,1,5,22,6004
0,0,8,0,0,0,8,6007
3,2,7,3,2,5,22,6009
1,1,3,1,0,2,8,6012
5,5,4,3,0,11,28,6013
0,0,4,4,1,0,9,6015
1,1,3,1,0,2,8,6017
0,0,7,0,0,0,7,6019
3,0,3,2,0,3,11,6020
3,0,2,1,1,2,9,6022
0,0,5,5,0,4,14,6023
0,0,12,2,0,2,16,6024
0,0,7,0,0,0,7,6026
0,0,18,1,0,2,21,6027
2,1,4,1,0,1,9,6030
0,0,5,5,0,4,14,6031
3,0,7,2,0,4,16,6032
0,0,8,0,0,0,8,6033
2,1,4,1,0,1,9,6034
0,0,8,2,0,1,11,6036
2,2,10,4,0,10,28,6037
1,0,14,0,0,6,21,6038
3,6,7,1,0,6,23,6039
0,0,8,1,0,0,9,6041
0,0,10,0,0,2,12,6043
5,3,5,0,0,3,16,6045
0,1,11,3,0,6,21,6047
3,0,5,0,0,4,12,6048
3,2,7,1,0,6,19,6049
1,0,4,0,0,0,5,6050
1,0,13,1,0,5,20,6051
3,0,11,4,0,2,20,6053
6,2,10,0,1,4,23,6055
0,0,5,1,0,2,8,6056
0,0,9,0,0,4,13,6057
1,1,9,1,0,3,15,6058
4,1,11,1,2,6,25,6059
7,1,10,0,1,7,26,6060
3,0,4,1,1,5,14,6061
4,0,9,1,0,10,24,6064
5,2,5,1,1,5,19,6065
1,0,4,0,1,0,6,6066
1,0,8,1,0,4,14,6069
2,0,5,2,0,4,13,6070
2,0,16,0,1,1,20,6071
1,0,9,1,0,7,18,6072
2,0,3,0,0,2,7,6073
1,0,8,0,2,5,16,6074
4,1,5,1,1,6,18,6075
4,1,12,2,1,3,23,6076
0,0,8,0,0,4,12,6078
2,1,13,1,0,5,22,6083
3,3,9,0,0,4,19,6084
0,0,4,0,0,2,6,6085
2,3,8,3,0,4,20,6086
4,3,6,0,1,9,23,6087
6,2,5,2,1,2,18,6088
4,3,6,0,1,9,23,6090
3,0,5,0,1,8,17,6091
2,1,7,2,0,9,21,6092
0,0,5,0,0,1,6,6093
1,1,11,1,0,8,22,6094
2,1,7,2,0,9,21,6096
4,3,6,0,1,9,23,6097
7,4,5,1,3,5,25,6098
5,2,6,2,1,2,18,6099
4,2,9,3,0,8,26,6100
1,2,1,2,0,1,7,6102
1,2,2,0,1,4,10,6103
5,1,3,0,2,4,15,6104
1,1,11,1,0,8,22,6105
5,5,7,1,0,7,25,6106
1,2,6,1,0,6,16,6108
9,7,3,1,0,8,28,6109
2,1,7,2,0,9,21,6110
4,3,6,0,1,9,23,6111
6,2,5,2,1,2,18,6112
8,4,5,1,3,5,26,6113
0,0,14,1,0,2,17,6115
5,2,6,2,1,2,18,6116
4,3,6,0,1,9,23,6118
7,4,5,1,3,5,25,6119
3,2,5,2,2,4,18,6120
1,1,11,1,0,8,22,6123
6,2,5,2,1,2,18,6125
1,0,7,0,0,2,10,6126
0,0,5,0,0,0,5,6127
2,1,2,1,2,2,10,6128
8,2,5,1,3,3,22,6130
4,3,6,0,1,9,23,6132
4,1,7,0,1,5,18,6133
8,4,5,1,3,5,26,6134
1,0,8,0,0,3,12,6135
4,3,8,2,1,4,22,6137
2,0,12,1,0,5,20,6138
3,1,11,2,1,8,26,6140
3,0,7,1,1,4,16,6141
3,0,9,1,1,4,18,6145
0,0,7,1,0,2,10,6146
3,2,8,0,1,4,18,6147
3,1,7,1,0,2,14,6148
2,1,6,0,0,2,11,6150
1,0,9,0,0,3,13,6151
1,0,11,2,0,5,19,6152
3,5,5,1,1,9,24,6153
1,0,8,0,0,4,13,6154
3,1,9,1,0,4,18,6156
0,0,7,0,0,4,11,6159
0,0,11,0,0,1,12,6160
0,0,13,0,0,2,15,6162
3,0,9,1,1,4,18,6163
1,0,11,0,0,3,15,6164
0,0,16,0,0,1,17,6165
2,2,4,2,0,5,15,6166
0,0,3,0,0,1,4,6167
2,0,12,1,0,3,18,6169
1,0,8,0,0,3,12,6170
1,0,9,0,0,3,13,6171
0,0,2,1,0,0,3,6173
2,0,12,1,0,5,20,6174
3,1,7,3,4,3,21,6175
1,0,8,0,0,3,12,6178
0,0,16,0,0,1,17,6181
3,0,11,1,0,5,20,6183
1,0,17,0,0,4,22,6184
0,0,9,0,0,1,10,6185
2,1,9,0,0,4,16,6187
1,0,11,0,0,2,14,6188
2,0,5,0,0,2,9,6191
1,0,11,0,0,1,13,6192
2,0,5,0,0,2,9,6193
0,0,8,0,0,3,11,6195
0,0,7,0,0,1,8,6196
2,1,11,0,0,4,18,6197
0,0,7,0,0,2,9,6198
2,0,5,0,0,2,9,6199
2,0,5,0,0,2,9,6200
0,0,7,0,0,1,8,6201
1,0,4,0,0,2,7,6202
1,0,12,1,0,2,16,6203
2,0,5,0,0,2,9,6206
2,0,5,0,0,2,9,6207
0,0,8,0,0,1,9,6208
1,0,13,0,0,1,15,6211
0,0,8,0,0,0,8,6213
1,0,8,1,0,1,11,6215
1,0,8,1,1,2,13,6216
1,0,8,0,0,1,10,6217
0,0,7,0,0,1,8,6218
1,0,8,0,0,1,10,6219
1,0,7,3,0,2,13,6220
1,0,8,0,0,1,10,6222
1,0,7,3,0,2,13,6223
2,0,6,1,0,4,13,6224
6,2,4,2,0,4,18,6226
0,0,10,0,0,3,13,6227
1,0,7,1,0,1,10,6230
2,0,5,0,0,2,9,6232
2,0,8,0,0,3,13,6233
1,0,10,0,0,1,12,6234
0,0,8,0,0,2,10,6240
5,2,6,1,2,6,22,6241
3,0,9,3,0,3,18,6243
3,0,9,3,0,3,18,6244
3,0,9,3,0,3,18,6245
3,0,9,3,0,3,18,6246
0,0,15,1,0,3,19,6247
3,0,9,3,0,3,18,6248
3,0,9,3,0,3,18,6253
0,0,8,0,0,2,10,6254
3,0,9,3,0,3,18,6255
3,0,9,3,0,3,18,6256
2,0,7,0,0,1,10,6257
2,0,18,2,0,4,26,6258
3,0,9,3,0,3,18,6259
3,0,9,3,0,3,18,6261
3,0,9,3,0,3,18,6262
7,2,4,1,2,7,23,6263
3,0,9,3,0,3,18,6265
3,0,9,3,0,3,18,6267
2,0,9,0,0,2,13,6268
0,0,9,1,0,6,16,6269
4,0,5,1,0,4,14,6271
3,0,9,3,0,3,18,6272
7,4,5,2,1,7,26,6273
3,0,9,3,0,3,18,6274
3,0,9,3,0,3,18,6276
0,0,8,0,0,2,10,6277
2,1,10,1,0,1,15,6278
0,0,8,0,0,2,10,6281
4,2,8,1,0,1,16,6282
3,0,9,3,0,3,18,6283
0,0,12,1,0,3,16,6292
3,0,19,3,0,2,27,6293
3,5,4,0,1,3,16,6294
5,1,6,0,2,8,22,6296
5,0,12,2,0,2,21,6297
3,0,5,2,1,0,11,6299
0,0,3,0,0,2,5,6300
1,1,8,0,0,1,11,6301
2,0,5,1,5,4,17,6302
2,0,7,0,0,2,11,6303
2,1,2,1,0,3,9,6304
8,3,3,5,1,12,32,6305
0,0,11,0,0,0,11,6306
2,0,8,0,0,1,11,6310
1,1,9,2,0,4,17,6311
2,0,6,3,0,10,21,6312
2,0,7,0,0,2,11,6314
4,0,8,1,0,7,20,6315
2,0,7,0,0,2,11,6317
5,4,2,0,0,3,14,6318
6,5,5,3,1,3,23,6320
3,0,13,0,1,5,22,6322
5,5,4,1,1,4,20,6323
5,5,6,0,0,5,21,6325
2,0,6,1,0,2,11,6326
4,0,9,1,0,2,16,6328
3,0,5,0,1,2,11,6329
2,1,3,1,1,5,13,6330
4,1,8,0,1,6,20,6331
3,1,2,0,0,0,6,6332
3,0,10,2,0,5,20,6334
3,1,8,2,0,6,20,6335
2,0,7,2,1,8,20,6336
2,0,7,2,1,8,20,6337
3,0,8,2,1,2,16,6338
2,0,7,0,1,8,18,6339
3,0,12,3,0,3,21,6340
1,0,6,1,2,3,13,6341
0,0,9,0,0,1,10,6342
2,1,5,0,0,1,9,6343
2,0,7,2,1,8,20,6344
2,0,7,2,1,8,20,6345
2,3,9,1,0,3,18,6346
1,1,7,0,0,3,12,6347
2,0,7,0,1,8,18,6348
2,0,5,2,3,2,14,6349
2,4,9,1,0,5,21,6350
0,0,15,0,0,3,18,6354
4,1,8,3,0,3,19,6355
0,0,9,0,0,1,10,6356
2,0,8,0,1,8,19,6358
2,2,6,0,0,6,16,6361
2,0,11,1,0,11,25,6362
1,0,4,1,0,1,7,6363
2,0,7,2,1,8,20,6365
2,0,7,2,1,8,20,6366
0,0,15,1,0,1,17,6369
1,0,13,0,0,2,16,6370
2,1,8,0,1,7,19,6371
0,0,15,0,0,3,18,6372
4,0,11,1,0,3,19,6373
0,0,12,2,0,1,15,6374
0,0,15,0,0,3,18,6375
0,0,10,0,0,5,15,6376
2,0,7,2,1,8,20,6380
2,0,7,2,1,8,20,6382
4,0,10,2,1,10,27,6383
2,0,11,1,3,7,24,6384
2,2,4,0,0,4,12,6385
0,0,3,0,0,1,4,6386
3,1,4,2,1,4,15,6387
0,0,12,1,0,1,14,6388
1,2,2,1,0,2,8,6389
0,0,12,1,0,1,14,6391
0,0,3,2,0,0,5,6392
2,0,0,2,0,1,5,6393
2,3,1,0,1,1,8,6394
0,0,16,0,0,1,17,6395
1,1,5,1,0,1,9,6396
1,0,2,1,3,2,9,6397
3,1,6,1,0,3,14,6398
2,1,3,1,1,2,10,6399
0,0,3,0,0,1,4,6400
0,0,2,0,0,0,2,6402
0,0,8,0,0,5,13,6403
0,0,12,1,0,2,15,6404
1,0,10,0,0,1,12,6405
1,0,3,1,0,1,6,6406
1,1,2,1,1,0,6,6407
1,1,2,0,0,1,5,6410
2,1,4,0,0,1,8,6412
0,0,7,0,0,4,11,6413
0,0,16,0,0,1,17,6414
1,1,5,1,0,1,9,6415
2,0,13,3,2,0,20,6416
4,0,13,0,0,5,22,6417
1,0,10,2,2,6,21,6418
6,1,8,1,2,4,22,6420
0,0,12,1,0,1,14,6421
0,0,5,0,0,3,8,6422
0,0,16,0,0,1,17,6423
0,0,3,0,0,0,3,6425
2,0,6,3,1,2,14,6427
0,0,1,1,0,1,3,6429
5,3,9,0,0,8,25,6430
2,1,4,0,0,3,10,6434
2,0,10,1,0,5,18,6436
4,0,11,3,0,5,23,6438
2,0,4,1,0,3,10,6440
2,1,3,0,0,3,9,6441
4,0,5,3,0,2,14,6443
1,0,10,4,0,4,19,6445
3,0,5,0,0,1,9,6446
3,0,12,0,1,2,18,6448
4,1,3,2,0,3,13,6449
4,0,6,1,2,5,18,6450
4,1,1,1,0,3,10,6451
1,0,1,0,2,1,5,6452
2,0,11,2,0,4,19,6453
1,0,6,3,0,5,15,6454
2,1,4,0,0,1,8,6455
2,0,7,0,1,1,11,6458
6,4,4,1,0,9,24,6459
6,3,5,2,1,7,24,6461
1,0,5,1,0,2,9,6462
5,1,6,1,0,5,18,6463
3,0,9,1,1,3,17,6464
1,0,0,1,2,0,4,6465
1,0,23,0,0,0,24,6466
2,0,9,1,0,4,16,6467
4,0,9,1,1,3,18,6469
1,0,8,3,0,6,18,6470
2,0,10,1,0,4,17,6472
2,0,8,1,0,5,16,6473
6,1,5,2,1,7,22,6474
3,0,9,1,1,3,17,6477
1,0,14,0,0,2,17,6478
3,0,6,0,0,1,10,6480
1,0,9,2,0,6,18,6481
3,2,2,1,1,1,10,6482
3,0,9,1,1,3,17,6484
4,0,1,0,1,2,8,6485
1,0,8,3,0,2,14,6486
2,0,4,2,1,7,16,6490
2,0,8,3,0,11,24,6491
2,2,8,3,0,4,19,6492
3,1,9,2,1,6,22,6493
2,1,11,1,2,4,21,6494
3,3,9,1,0,3,19,6495
1,0,3,0,1,3,8,6497
5,2,7,3,1,5,23,6499
3,1,5,0,1,4,14,6500
1,0,10,5,0,4,20,6501
1,0,5,1,4,1,12,6504
2,1,8,3,0,5,19,6505
1,0,13,1,0,5,20,6506
0,0,8,1,0,4,13,6510
6,3,7,1,1,7,25,6511
2,0,7,2,0,4,15,6512
3,1,7,0,0,3,14,6513
6,4,3,1,3,5,22,6514
1,0,8,1,2,4,16,6515
4,0,7,2,0,3,16,6516
3,1,2,1,2,2,11,6518
2,0,5,1,0,1,9,6519
3,0,3,1,0,1,8,6520
3,0,12,1,0,6,22,6523
2,0,7,1,0,3,13,6525
4,3,6,2,2,6,23,6527
3,0,10,0,1,1,15,6528
2,0,7,2,0,2,13,6529
4,0,3,0,0,1,8,6530
1,0,6,0,0,3,10,6532
3,0,9,1,1,5,19,6534
3,1,12,1,0,0,17,6535
1,0,10,0,0,2,13,6536
0,1,10,2,0,4,17,6537
1,1,9,1,0,1,13,6540
3,1,6,2,0,1,13,6541
3,2,7,1,0,3,16,6542
0,0,11,0,0,4,15,6543
11,5,6,4,1,7,34,6545
1,0,6,2,1,6,16,6546
1,0,7,0,0,1,9,6547
0,1,10,2,0,4,17,6548
3,1,12,2,1,7,26,6549
0,0,15,0,0,0,15,6550
0,0,19,1,0,2,22,6551
3,2,10,3,0,5,23,6552
3,0,10,1,0,1,15,6553
1,0,7,1,1,2,12,6554
0,0,4,2,0,1,7,6555
1,0,9,1,1,1,13,6556
6,5,4,1,1,10,27,6559
1,1,13,1,0,2,18,6560
1,0,7,0,1,2,11,6561
1,0,6,0,0,4,11,6565
0,1,10,2,0,4,17,6566
2,1,10,1,0,0,14,6567
0,0,6,0,1,4,11,6568
0,0,5,1,0,1,7,6569
3,0,4,0,0,1,8,6570
0,1,9,2,0,4,16,6571
3,0,10,0,0,1,14,6572
4,2,12,3,0,5,26,6573
1,0,6,2,1,6,16,6575
1,0,7,0,0,2,10,6576
4,2,7,1,0,5,19,6577
1,0,6,2,1,6,16,6579
1,3,13,4,1,4,26,6580
0,1,9,2,0,4,16,6582
0,0,7,0,0,4,11,6583
5,1,5,2,1,5,19,6585
2,2,2,1,1,1,9,6586
4,1,7,2,0,4,18,6588
3,2,11,3,1,3,23,6591
4,1,10,2,0,3,20,6593
5,2,6,0,2,9,24,6594
5,1,5,2,1,5,19,6596
3,2,6,1,1,5,18,6597
4,1,6,0,0,2,13,6598
4,4,8,1,1,4,22,6601
4,2,2,1,1,3,13,6602
5,5,5,1,2,5,23,6603
7,0,7,0,2,6,22,6604
4,0,10,1,0,5,20,6605
4,0,9,0,0,7,20,6607
4,1,2,1,1,0,9,6608
4,0,7,2,2,6,21,6610
6,3,4,2,0,5,20,6611
2,0,7,1,1,2,13,6613
2,0,7,5,0,7,21,6614
7,0,3,0,2,6,18,6616
6,2,4,3,3,4,22,6617
4,3,11,0,0,9,27,6619
4,0,10,3,1,7,25,6621
1,1,1,1,0,1,5,6622
5,0,4,1,1,6,17,6624
5,2,9,0,0,2,18,6625
3,2,6,2,0,5,18,6626
4,1,7,3,1,10,26,6627
3,2,6,3,2,7,23,6628
2,0,10,0,0,6,18,6629
7,3,12,2,0,6,30,6630
1,0,4,0,1,2,8,6631
5,0,7,5,3,7,27,6632
7,2,8,2,3,4,26,6634
0,0,13,0,0,0,13,6635
4,2,5,2,1,10,24,6636
3,0,4,1,0,5,13,6637
0,0,9,1,0,1,11,6638
1,0,12,1,0,2,16,6642
2,1,9,0,2,4,18,6643
0,0,3,1,2,4,10,6644
1,0,3,2,1,2,9,6646
1,0,3,0,0,2,6,6647
0,0,7,0,0,1,8,6648
0,0,3,0,0,2,5,6649
0,0,18,0,0,1,19,6653
3,0,6,0,0,8,17,6654
5,3,4,4,1,4,21,6655
1,0,4,1,0,1,7,6656
3,2,12,1,0,6,24,6658
1,0,6,0,1,3,11,6660
4,1,7,1,1,9,23,6661
0,0,5,1,0,1,7,6662
1,0,19,0,0,2,22,6663
3,2,7,2,0,8,22,6664
2,0,8,2,1,5,18,6665
5,2,9,1,1,5,23,6667
0,0,5,2,0,3,10,6668
3,1,10,2,0,4,20,6669
2,0,4,0,1,1,8,6670
2,3,5,1,0,6,17,6672
1,1,10,1,0,4,17,6675
1,1,7,2,1,5,17,6676
2,2,9,3,2,6,24,6678
1,0,6,1,0,3,11,6679
3,0,6,2,2,10,23,6681
0,0,11,3,0,6,20,6682
4,0,8,0,0,4,16,6683
0,0,6,1,0,5,12,6686
5,3,4,1,3,8,24,6687
0,0,3,0,1,4,8,6688
1,0,5,0,0,2,8,6689
3,0,10,2,0,8,23,6690
4,1,10,1,1,9,26,6693
2,1,4,1,0,3,11,6694
0,0,5,0,0,3,8,6695
2,0,12,4,0,6,24,6697
1,1,5,0,1,2,10,6699
2,0,6,2,1,5,16,6700
2,0,3,1,0,3,9,6701
3,0,7,2,0,4,16,6702
3,4,4,2,0,2,15,6703
0,0,7,1,0,1,9,6706
5,5,11,0,0,4,25,6707
3,4,5,3,0,5,20,6708
4,2,6,1,1,4,18,6709
2,3,9,0,1,4,19,6711
2,1,3,0,1,2,9,6712
4,0,1,2,1,3,11,6714
4,2,5,1,1,4,17,6716
1,1,3,0,0,0,5,6719
1,2,1,0,0,0,4,6721
0,0,7,1,0,1,9,6722
2,1,10,1,0,6,20,6723
0,0,5,1,0,0,6,6724
0,0,14,0,0,6,20,6725
2,0,7,2,0,4,15,6726
1,1,1,0,0,0,3,6727
1,1,4,0,0,1,7,6729
3,2,7,2,0,5,19,6730
0,0,8,1,0,0,9,6731
1,2,0,0,0,0,3,6734
2,1,9,1,1,6,20,6735
0,0,5,0,1,1,7,6736
5,3,9,0,0,8,25,6737
3,0,6,4,3,9,25,6738
1,0,15,0,0,4,20,6742
1,1,3,0,0,1,6,6744
0,0,8,1,0,0,9,6745
4,2,3,0,1,6,16,6746
5,2,9,1,0,4,21,6748
1,0,5,1,0,3,10,6749
2,0,9,2,0,5,18,6751
4,3,3,1,2,1,14,6754
2,0,1,1,1,2,7,6756
1,0,9,0,0,4,14,6757
3,0,8,2,0,8,21,6758
2,0,14,2,0,8,26,6759
6,1,4,0,0,5,16,6760
3,0,5,1,2,2,13,6762
2,0,10,2,0,5,19,6764
0,0,6,0,0,2,8,6765
3,0,5,0,0,2,10,6766
0,0,8,1,0,7,16,6767
0,0,2,1,0,1,4,6769
2,0,6,1,2,3,14,6772
1,0,4,1,0,2,8,6773
3,0,5,1,2,2,13,6774
1,0,12,0,0,2,15,6775
1,0,6,2,0,3,12,6776
3,0,6,1,0,10,20,6779
1,0,10,0,0,3,14,6781
2,1,5,0,1,0,9,6783
1,1,4,0,1,0,7,6784
1,2,4,1,0,3,11,6785
3,0,12,0,0,10,25,6787
1,0,12,0,0,2,15,6788
2,0,7,0,0,3,12,6789
0,0,1,1,0,2,4,6790
4,2,8,1,0,7,22,6792
3,0,7,0,0,3,13,6793
4,0,4,1,0,6,15,6794
2,1,5,1,0,4,13,6795
6,3,6,2,1,7,25,6796
4,3,8,2,2,6,25,6799
4,3,5,3,3,7,25,6800
1,0,3,2,1,4,11,6801
3,1,2,3,0,0,9,6802
4,3,7,2,2,6,24,6804
5,3,6,1,0,9,24,6806
4,3,7,2,3,6,25,6807
4,3,6,3,2,7,25,6808
4,3,5,4,2,7,25,6809
5,3,6,2,0,10,26,6810
5,4,5,1,1,6,22,6811
4,3,7,3,2,6,25,6813
5,2,6,1,3,8,25,6814
4,1,7,3,0,11,26,6815
3,2,4,1,1,3,14,6817
4,3,5,4,2,7,25,6819
2,2,6,6,1,9,26,6820
1,0,6,3,0,4,14,6821
4,3,7,2,2,6,24,6823
4,3,7,2,2,6,24,6824
3,2,10,0,0,1,16,6828
4,3,7,2,2,6,24,6830
4,3,8,2,2,6,25,6832
6,4,6,2,3,10,31,6833
4,3,7,2,2,6,24,6834
5,3,5,1,2,11,27,6835
4,3,7,2,2,6,24,6837
3,2,1,1,1,1,9,6839
3,0,13,1,1,10,28,6841
2,0,10,4,1,5,22,6843
4,3,7,2,2,6,24,6844
3,2,3,2,0,6,16,6845
4,3,7,2,2,6,24,6847
2,2,5,2,1,6,18,6848
4,2,6,0,2,5,19,6849
2,1,7,2,2,4,18,6850
1,1,4,0,0,2,8,6852
6,0,8,2,2,9,27,6854
4,2,7,1,2,6,22,6855
3,1,8,3,1,2,18,6857
1,1,2,1,1,0,6,6858
0,0,13,1,0,10,24,6860
3,0,4,1,2,3,13,6861
1,0,9,0,0,4,14,6862
1,2,4,0,0,2,9,6863
2,0,11,0,0,3,16,6864
0,0,10,1,0,3,14,6867
1,0,11,1,2,7,22,6870
2,1,7,1,0,4,15,6872
3,1,6,2,0,6,18,6874
2,0,4,1,1,3,11,6875
4,1,7,1,1,5,19,6876
1,1,6,0,0,4,12,6877
3,1,9,3,0,4,20,6878
1,1,10,0,0,6,18,6879
4,2,8,0,1,8,23,6880
3,1,6,2,0,6,18,6881
4,0,8,2,1,7,22,6882
4,0,6,1,2,3,16,6883
0,0,4,0,2,1,7,6884
4,2,4,1,1,5,17,6885
1,0,7,2,3,3,16,6890
2,0,10,0,1,2,15,6892
3,0,6,1,1,3,14,6893
1,1,8,2,2,7,21,6896
5,2,7,3,2,5,24,6897
0,0,8,2,0,4,14,6898
1,0,3,0,0,1,5,6900
3,1,10,1,0,8,23,6903
3,1,8,2,1,7,22,6905
1,0,8,0,0,2,11,6907
4,4,10,3,0,6,27,6908
2,0,9,0,0,5,16,6909
2,1,14,1,2,4,24,6910
4,2,6,2,0,9,23,6911
3,2,8,4,2,6,25,6912
5,5,6,2,1,5,24,6913
1,1,3,1,0,3,9,6914
6,1,5,3,0,5,20,6915
3,2,7,0,1,4,17,6916
6,0,7,0,0,7,20,6917
2,1,6,1,0,3,13,6918
2,0,11,1,0,4,18,6919
1,0,3,1,0,0,5,6920
1,0,7,2,2,2,14,6921
2,0,5,1,0,3,11,6925
4,5,6,0,1,5,21,6926
2,3,4,0,2,4,15,6928
1,0,3,1,0,1,6,6929
7,3,5,0,0,9,24,6930
1,0,5,1,1,1,9,6931
1,1,7,0,0,2,11,6932
2,0,5,3,0,3,13,6933
0,0,8,0,0,2,10,6935
3,1,9,0,2,7,22,6936
0,0,2,1,0,1,4,6937
0,0,8,1,0,2,11,6939
0,0,4,0,0,2,6,6940
2,1,7,0,0,5,15,6943
4,1,5,3,1,7,21,6945
1,0,9,2,0,1,13,6946
1,0,8,1,0,1,11,6948
1,1,6,1,1,2,12,6949
1,0,9,2,0,1,13,6950
2,1,14,0,1,2,20,6951
0,0,11,0,0,3,14,6953
6,0,6,3,2,6,23,6954
1,0,12,0,0,3,16,6955
3,0,7,0,0,4,14,6956
3,0,8,0,0,1,12,6959
2,0,8,0,1,5,16,6960
5,0,7,1,1,4,18,6961
0,0,2,0,0,0,2,6962
1,1,1,1,0,0,4,6963
3,1,4,0,0,0,8,6965
1,0,11,0,0,5,17,6966
1,1,1,0,0,1,4,6967
5,2,5,1,1,6,20,6970
6,3,7,2,2,2,22,6971
0,0,16,1,0,3,20,6972
1,0,4,0,0,4,9,6973
2,2,4,0,0,3,11,6974
1,0,8,0,0,2,11,6975
7,4,6,0,2,5,24,6977
1,1,8,2,5,2,19,6978
0,0,12,0,0,1,13,6979
3,0,8,3,0,8,22,6980
1,0,7,0,0,1,9,6981
2,1,6,2,4,6,21,6983
3,0,12,0,0,8,23,6984
1,0,9,1,0,2,13,6985
1,0,9,2,0,1,13,6988
4,0,8,2,0,8,22,6990
2,1,10,3,0,4,20,6992
1,0,3,1,1,2,8,6994
2,0,10,0,1,4,17,6996
1,1,3,2,0,3,10,6998
1,0,11,0,0,2,14,6999
4,1,0,2,1,2,10,7001
1,1,6,1,0,2,11,7002
0,0,11,0,0,4,15,7005
3,2,3,0,2,3,13,7006
0,0,11,0,0,4,15,7008
1,1,14,1,0,3,20,7009
1,0,1,1,0,0,3,7010
3,1,1,0,1,1,7,7012
5,2,7,0,2,5,21,7013
0,0,16,1,0,4,21,7015
1,1,0,0,4,0,6,7018
1,2,5,1,0,5,14,7019
0,0,7,0,0,2,9,7021
0,0,12,1,0,0,13,7023
0,0,11,0,0,4,15,7024
1,1,5,1,0,1,9,7025
1,0,8,4,0,5,18,7026
1,1,14,1,0,3,20,7027
2,0,3,1,0,1,7,7029
6,2,6,3,1,5,23,7030
1,0,11,0,0,2,14,7031
1,0,5,2,0,3,11,7032
0,0,11,0,0,4,15,7036
2,0,5,2,1,6,16,7037
1,0,5,0,0,1,7,7039
1,1,6,1,0,2,11,7043
0,0,16,1,0,4,21,7044
4,3,7,2,2,9,27,7046
2,1,8,1,0,2,14,7047
0,0,6,0,0,0,6,7048
0,0,3,1,0,4,8,7050
2,1,6,1,1,3,14,7051
1,0,2,2,0,0,5,7052
2,2,9,1,0,2,16,7053
6,1,7,0,0,8,22,7054
2,1,4,0,0,2,9,7056
2,2,2,0,0,1,7,7058
8,3,3,1,2,9,26,7059
5,1,3,2,0,4,15,7060
0,0,10,1,0,4,15,7061
1,0,8,0,0,3,12,7063
4,2,10,0,2,4,22,7065
3,3,12,0,1,4,23,7068
5,6,6,1,3,4,25,7069
1,1,2,1,0,4,9,7070
5,3,4,0,1,4,17,7071
0,0,7,1,0,3,11,7073
2,1,4,1,0,5,13,7074
0,0,2,1,0,1,4,7075
0,0,8,2,0,1,11,7076
5,2,8,1,0,8,24,7077
1,1,4,2,2,5,15,7078
0,0,1,2,1,1,5,7080
1,0,4,0,0,0,5,7081
3,1,9,4,1,5,23,7086
0,0,1,0,0,0,1,7088
2,1,5,1,1,3,13,7089
1,0,5,3,0,2,11,7091
2,0,9,1,0,4,16,7092
1,0,7,1,0,4,13,7093
0,0,10,3,0,6,19,7095
3,2,3,1,3,3,15,7097
0,0,9,3,0,2,14,7098
5,1,12,1,0,6,25,7104
1,1,18,1,0,4,25,7105
1,1,7,2,0,6,17,7106
1,0,10,0,0,1,12,7108
0,0,8,3,0,0,11,7109
3,0,3,1,1,1,9,7111
0,0,8,0,1,2,11,7112
1,0,11,3,0,2,17,7114
2,3,6,4,0,2,17,7115
1,0,10,0,0,1,12,7116
2,3,5,1,3,4,18,7118
1,1,7,2,0,6,17,7120
2,1,4,1,0,4,12,7121
1,0,6,3,1,2,13,7122
1,1,7,2,0,6,17,7124
4,2,5,4,0,7,22,7125
4,1,6,3,1,1,16,7126
3,0,6,4,0,5,18,7128
2,1,4,1,0,4,12,7129
0,0,10,1,0,2,13,7130
3,0,9,1,0,6,19,7131
2,1,4,1,0,4,12,7132
2,1,4,1,0,4,12,7134
1,1,7,2,0,6,17,7135
0,0,9,0,0,2,11,7136
1,1,7,2,0,6,17,7137
9,6,3,3,1,9,31,7138
3,0,11,0,0,4,18,7140
0,0,14,0,0,3,17,7141
0,0,13,0,0,3,16,7142
5,2,5,2,1,8,23,7144
4,1,4,0,0,2,11,7146
2,1,3,0,1,6,13,7147
0,0,8,0,0,6,14,7148
2,1,3,0,1,5,12,7149
4,1,3,2,1,5,16,7150
0,0,6,0,0,1,7,7154
2,1,4,0,0,7,14,7155
1,1,10,1,0,4,17,7157
1,0,7,0,3,0,11,7158
1,1,7,0,0,8,17,7159
1,1,3,1,0,3,9,7160
0,2,4,1,0,1,8,7161
0,0,11,0,0,3,14,7163
2,2,3,0,0,4,11,7164
6,2,3,1,1,6,19,7165
1,0,4,3,1,2,11,7166
2,1,1,0,0,0,4,7167
4,3,8,2,0,10,27,7168
0,0,8,0,0,1,9,7169
0,0,5,1,0,4,10,7171
0,0,2,1,0,1,4,7173
3,0,8,0,0,7,18,7174
3,1,6,0,1,8,19,7175
2,0,8,3,1,5,19,7176
4,2,3,3,1,3,16,7178
1,0,1,0,0,1,3,7179
2,0,1,3,1,2,9,7180
1,0,3,1,0,0,5,7183
0,0,9,0,0,1,10,7184
1,0,2,0,0,3,6,7185
1,0,4,0,0,1,6,7186
1,0,3,0,1,0,5,7187
1,0,5,0,0,7,13,7188
0,1,6,0,0,3,10,7191
1,1,3,0,0,2,7,7192
3,0,6,1,4,6,20,7193
1,0,2,0,2,4,9,7194
2,0,2,3,0,4,11,7195
2,0,5,2,1,6,16,7196
5,2,9,1,0,5,22,7197
3,1,4,1,0,4,13,7198
2,0,6,1,0,3,12,7199
4,0,8,2,0,3,17,7201
2,0,6,3,1,8,20,7202
1,0,2,1,2,1,7,7203
1,3,4,1,0,1,10,7204
2,0,12,3,1,7,25,7205
2,0,9,1,0,7,19,7206
5,0,5,4,0,8,22,7208
1,0,8,1,0,0,10,7210
3,2,3,1,1,7,17,7211
3,3,6,2,1,7,22,7213
1,3,10,3,2,6,25,7214
0,0,10,2,0,2,14,7215
2,2,5,1,0,5,15,7218
1,1,11,1,0,4,18,7221
5,1,2,2,0,6,16,7223
2,0,4,4,0,5,15,7224
6,2,5,2,2,8,25,7226
3,1,10,3,1,6,24,7227
3,3,2,1,0,3,12,7228
2,1,4,0,0,1,8,7229
4,1,4,2,0,5,16,7230
0,0,9,2,0,3,14,7231
5,1,11,3,0,4,24,7232
3,0,4,3,1,6,17,7234
3,0,7,2,0,6,18,7235
2,1,8,3,0,4,18,7236
4,1,4,2,0,5,16,7241
1,3,4,1,0,1,10,7242
2,1,9,3,0,5,20,7244
2,0,8,2,0,3,15,7247
1,0,9,0,0,3,13,7248
1,0,6,2,0,0,9,7250
2,0,12,4,0,5,23,7251
4,0,9,1,0,1,15,7252
3,0,5,6,1,3,18,7253
3,0,7,4,0,3,17,7254
0,0,10,0,0,0,10,7255
3,0,2,2,2,2,11,7256
3,0,8,1,2,7,21,7260
2,0,4,2,0,3,11,7261
2,1,10,4,0,9,26,7264
2,0,4,2,0,3,11,7265
1,0,9,0,0,1,11,7266
5,2,6,1,1,6,21,7267
4,1,6,5,0,7,23,7268
2,0,12,3,1,4,22,7270
1,0,6,5,0,6,18,7272
2,0,6,0,0,3,11,7274
1,0,10,7,0,5,23,7275
2,0,13,0,0,1,16,7277
2,0,8,0,0,5,15,7278
0,0,5,2,1,2,10,7280
1,0,9,1,0,6,17,7281
1,0,6,3,0,5,15,7283
0,0,6,0,0,3,9,7285
3,1,9,2,0,8,23,7286
3,0,7,2,0,5,17,7287
2,0,6,0,0,3,11,7288
2,0,7,4,1,6,20,7289
3,0,11,2,1,10,27,7290
1,0,8,4,0,4,17,7291
2,0,6,2,0,4,14,7292
1,1,7,3,2,3,17,7294
0,0,1,0,0,1,2,7295
2,0,7,3,0,4,16,7296
0,0,8,1,0,2,11,7297
1,0,6,1,0,5,13,7299
0,1,9,0,0,3,13,7300
2,0,9,3,2,4,20,7301
2,0,7,1,0,7,17,7302
0,0,13,0,0,2,15,7306
2,0,8,4,1,6,21,7307
0,0,6,0,0,1,7,7309
3,1,5,2,1,6,18,7310
2,0,4,2,0,3,11,7311
3,0,8,1,0,5,17,7312
2,0,9,3,0,6,20,7315
3,0,6,3,1,7,20,7316
0,0,13,1,1,0,15,7317
0,0,8,0,0,1,9,7318
3,1,6,5,3,8,26,7319
2,3,3,2,0,3,13,7320
0,0,3,3,0,1,7,7323
1,0,9,4,1,4,19,7324
2,0,7,2,1,2,14,7325
0,0,4,1,0,1,6,7326
0,0,5,0,0,2,7,7328
1,0,8,2,0,7,18,7329
2,0,3,3,1,3,12,7330
0,0,12,0,0,2,14,7331
0,0,9,2,0,4,15,7332
1,0,6,2,2,2,13,7334
1,0,6,3,1,1,12,7335
1,0,7,2,2,2,14,7337
1,0,4,2,1,1,9,7338
2,0,10,0,0,6,18,7340
1,1,7,3,1,8,21,7342
0,0,8,0,0,1,9,7343
1,1,5,2,0,4,13,7344
7,0,8,1,1,5,22,7345
0,0,11,0,0,7,18,7348
1,0,11,3,1,2,18,7350
5,1,10,0,3,3,22,7352
3,2,3,0,1,2,11,7354
3,1,11,4,1,6,26,7355
3,0,8,2,1,5,19,7356
0,0,13,0,0,0,13,7357
3,0,8,2,2,6,21,7358
0,1,4,1,0,2,8,7359
1,1,7,1,0,3,13,7360
2,1,4,2,1,5,15,7361
1,0,12,0,0,1,14,7362
2,0,3,1,1,3,10,7365
0,0,6,1,0,3,10,7366
1,0,2,0,0,2,5,7367
3,3,5,2,1,0,14,7369
2,2,3,1,0,1,9,7371
5,4,1,1,3,4,18,7372
4,0,3,2,0,2,11,7373
4,2,4,1,2,7,20,7374
6,3,8,1,0,6,24,7377
4,1,7,1,1,11,25,7378
2,3,5,0,0,3,13,7380
2,0,9,1,0,1,13,7381
4,3,5,2,2,7,23,7383
1,0,12,0,0,1,14,7386
2,1,4,1,0,7,15,7390
6,3,8,0,0,7,24,7391
1,0,12,0,0,1,14,7392
4,1,4,2,4,7,22,7393
3,1,5,1,0,1,11,7395
0,0,6,0,0,1,7,7397
1,0,0,0,0,0,1,7400
5,0,4,0,1,4,14,7402
1,1,5,2,0,3,12,7403
2,0,1,0,0,2,5,7405
6,2,7,1,1,2,19,7407
7,2,6,0,0,5,20,7408
5,0,7,2,0,6,20,7410
1,1,8,1,0,5,16,7412
1,1,6,0,0,3,11,7413
5,3,4,1,0,1,14,7414
1,1,6,0,0,3,11,7415
3,3,9,0,0,5,20,7416
4,1,7,0,0,10,22,7418
5,2,5,1,1,5,19,7419
4,2,8,1,3,7,25,7421
2,1,1,1,0,0,5,7424
4,0,7,2,0,7,20,7425
1,1,6,0,0,3,11,7426
1,0,2,0,1,1,5,7428
4,1,4,1,0,3,13,7430
4,1,1,0,0,3,9,7431
2,1,5,0,0,2,10,7433
3,0,4,1,2,1,11,7434
3,0,4,1,1,4,13,7437
1,1,6,0,0,3,11,7438
3,3,6,1,2,4,19,7439
8,2,4,3,0,9,26,7442
2,1,1,1,2,3,10,7443
3,1,2,0,0,0,6,7444
3,0,13,4,1,1,22,7446
3,0,6,0,1,4,14,7447
2,1,4,1,3,3,14,7451
1,0,6,0,1,3,11,7452
0,0,11,2,0,2,15,7453
6,2,8,2,2,7,27,7456
2,2,5,1,0,5,15,7457
4,1,7,1,2,4,19,7458
3,1,7,1,3,8,23,7459
1,0,6,0,0,2,9,7461
0,0,3,0,1,1,5,7463
1,0,6,0,0,2,9,7465
3,0,2,0,2,9,16,7467
2,1,4,1,2,6,16,7470
0,1,3,0,0,3,7,7473
0,0,4,1,0,5,10,7474
1,0,6,0,0,2,9,7475
2,0,9,1,0,6,18,7476
1,1,11,1,0,6,20,7477
2,0,9,0,0,15,26,7478
4,2,9,4,1,6,26,7479
1,0,6,1,0,2,10,7480
2,0,4,3,0,6,15,7481
0,0,11,0,0,0,11,7482
0,0,8,2,0,2,12,7488
1,0,6,0,1,3,11,7490
3,2,7,1,0,9,22,7491
3,0,13,1,0,3,20,7493
0,0,8,0,0,4,12,7494
0,0,17,0,0,4,21,7496
2,0,5,1,0,2,10,7497
3,0,10,2,0,4,19,7498
3,0,5,3,0,2,13,7501
0,0,11,0,0,3,14,7502
3,0,4,2,0,2,11,7503
3,0,4,2,0,2,11,7504
3,0,4,2,0,2,11,7505
3,0,4,2,0,2,11,7507
3,0,4,2,0,2,11,7510
0,0,12,0,0,1,13,7512
3,0,7,3,1,5,19,7513
0,0,11,0,0,1,12,7514
3,2,10,0,0,8,23,7515
1,0,13,1,0,1,16,7517
3,0,11,2,0,3,19,7518
3,1,7,0,0,8,19,7519
3,0,4,2,0,2,11,7520
3,0,6,2,0,2,13,7521
2,0,12,0,0,3,17,7522
4,0,6,2,0,2,14,7523
1,0,14,1,0,1,17,7525
3,0,6,3,1,4,17,7526
2,1,9,2,0,4,18,7527
3,0,7,2,0,2,14,7528
0,0,4,0,0,2,6,7529
2,0,7,0,0,1,10,7530
3,0,4,2,0,2,11,7531
3,0,4,2,0,2,11,7532
4,0,5,2,0,2,13,7533
3,0,5,2,0,2,12,7534
3,0,6,2,0,2,13,7535
3,0,6,2,0,2,13,7536
3,0,12,2,0,6,23,7537
3,0,4,2,0,2,11,7540
3,0,5,3,0,2,13,7542
0,0,8,0,0,1,9,7543
0,0,11,0,0,3,14,7544
2,0,7,2,0,8,19,7545
3,0,7,2,0,10,22,7547
2,0,7,2,0,8,19,7548
1,0,8,0,0,2,11,7550
2,0,8,3,0,3,16,7551
3,0,7,2,0,9,21,7552
0,1,8,0,0,7,16,7553
2,0,7,2,0,8,19,7554
2,1,7,1,0,10,21,7555
2,0,8,0,0,4,14,7556
2,0,7,2,0,8,19,7557
2,0,7,2,0,8,19,7558
3,0,7,2,0,10,22,7559
2,0,7,2,0,8,19,7560
2,0,7,2,0,8,19,7561
2,0,7,2,0,8,19,7563
2,0,7,2,0,7,18,7565
2,0,8,2,0,7,19,7566
4,1,6,2,0,11,24,7568
2,0,7,2,0,8,19,7569
2,0,7,2,0,8,19,7570
1,1,6,1,0,0,9,7571
2,0,7,2,0,8,19,7573
6,4,4,0,0,9,23,7576
2,0,7,2,0,8,19,7577
2,0,7,2,0,8,19,7578
2,0,7,2,0,8,19,7579
2,0,7,2,0,8,19,7580
0,0,8,0,0,3,11,7581
1,0,11,1,0,4,17,7582
2,0,7,2,0,8,19,7583
1,0,8,0,0,4,13,7584
2,0,7,2,0,8,19,7585
4,0,6,3,0,6,19,7587
2,0,7,2,0,8,19,7588
2,0,7,2,0,8,19,7589
3,0,9,3,2,6,23,7590
2,0,7,2,0,8,19,7591
3,0,7,2,0,6,18,7593
2,0,9,2,0,4,17,7594
0,0,5,0,0,0,5,7595
0,0,10,0,0,2,12,7598
0,0,10,0,0,5,15,7600
4,2,8,4,0,2,20,7601
0,0,9,0,0,2,11,7602
5,1,9,1,1,7,24,7603
3,0,8,0,0,7,18,7604
3,1,5,2,0,6,17,7605
1,0,3,0,3,1,8,7607
2,1,5,0,0,5,13,7608
0,0,9,0,0,2,11,7609
0,0,3,1,0,0,4,7610
4,3,3,1,0,2,13,7611
0,0,9,0,0,2,11,7612
0,0,9,0,0,2,11,7613
0,0,7,0,0,2,9,7614
1,1,9,0,0,9,20,7616
0,0,8,1,0,4,13,7617
0,0,7,0,0,2,9,7619
2,1,4,2,0,4,13,7621
0,0,9,0,0,2,11,7622
1,0,19,1,0,3,24,7623
0,0,9,0,0,2,11,7626
0,0,9,1,0,5,15,7627
2,1,3,0,0,3,9,7628
0,0,10,0,0,2,12,7630
1,0,6,3,0,1,11,7631
0,0,9,0,0,2,11,7633
4,1,3,0,0,3,11,7634
0,0,10,0,0,2,12,7635
0,0,9,0,0,2,11,7638
2,1,4,0,1,2,10,7639
0,0,7,2,1,8,18,7640
0,0,8,0,0,0,8,7641
0,0,9,0,0,2,11,7642
5,0,8,1,2,4,20,7643
0,0,11,0,0,2,13,7644
0,0,3,0,0,0,3,7645
0,0,5,0,0,2,7,7647
1,2,1,2,2,5,13,7648
3,0,9,2,0,10,24,7649
6,3,5,2,1,10,27,7650
2,1,3,1,0,2,9,7651
3,0,4,1,1,2,11,7652
3,3,8,2,0,4,20,7653
2,1,2,0,1,1,7,7654
0,1,5,1,0,1,8,7656
7,2,6,2,2,10,29,7657
1,1,14,1,0,5,22,7659
4,1,5,1,1,7,19,7661
6,2,4,2,3,4,21,7662
2,1,4,1,2,3,13,7663
3,0,6,2,0,8,19,7668
1,0,5,3,1,3,13,7669
1,0,6,0,0,3,10,7670
1,1,13,1,0,5,21,7671
3,6,5,1,0,6,21,7672
2,0,4,3,0,5,14,7674
0,0,12,2,0,0,14,7675
8,3,5,2,1,9,28,7677
5,6,7,1,2,6,27,7678
3,1,6,4,1,5,20,7679
0,0,1,2,0,0,3,7680
1,0,7,3,0,4,15,7681
3,0,3,2,0,2,10,7683
2,0,8,3,0,3,16,7685
4,1,5,2,1,12,25,7686
6,1,7,1,0,7,22,7687
0,0,3,5,1,3,12,7688
1,1,7,2,0,5,16,7689
6,3,9,2,1,7,28,7691
3,2,6,2,1,3,17,7692
1,0,1,2,0,1,5,7693
0,0,4,0,0,2,6,7694
6,0,5,2,2,9,24,7695
2,1,4,0,0,4,11,7696
2,1,5,3,0,3,14,7698
0,1,8,0,0,0,9,7699
2,0,6,0,1,3,12,7701
5,1,5,0,1,2,14,7702
4,2,2,0,1,3,12,7703
2,1,1,0,1,0,5,7707
1,1,7,3,2,4,18,7711
4,2,7,1,1,5,20,7712
2,0,6,0,1,3,12,7714
3,0,5,0,2,3,13,7715
2,0,4,0,1,1,8,7717
4,1,2,2,3,1,13,7718
4,4,8,1,3,4,24,7719
3,2,4,0,2,7,18,7720
5,3,3,1,1,5,18,7721
5,2,3,0,0,4,14,7722
2,0,3,0,0,3,8,7723
5,2,4,0,0,3,14,7724
7,6,4,2,0,4,23,7725
2,0,1,1,2,1,7,7727
2,0,5,0,1,1,9,7728
4,4,6,1,1,5,21,7731
3,1,3,1,3,5,16,7733
3,1,3,0,2,2,11,7735
2,1,2,0,1,0,6,7736
6,5,4,0,0,5,20,7737
3,0,7,3,4,2,19,7738
2,0,4,0,1,1,8,7739
1,1,2,0,0,2,6,7742
2,1,5,0,1,4,13,7743
5,1,6,0,0,5,17,7744
6,3,6,1,1,6,23,7746
2,1,10,1,0,7,21,7747
2,0,10,1,1,4,18,7748
4,2,4,0,0,3,13,7749
4,1,9,0,0,2,16,7750
2,1,8,1,0,3,15,7751
3,1,8,2,0,1,15,7752
1,0,13,4,2,4,24,7753
2,0,7,1,0,2,12,7754
0,0,15,0,0,5,20,7755
2,0,11,1,0,4,18,7756
1,0,6,0,0,3,10,7758
2,0,8,2,1,2,15,7759
1,0,9,1,0,4,15,7760
4,0,8,1,0,3,16,7761
3,0,4,2,1,5,15,7763
3,0,10,0,0,3,16,7764
0,0,14,0,0,4,18,7765
1,0,10,2,0,4,17,7766
3,0,10,1,0,3,17,7767
2,0,8,0,0,8,18,7768
1,0,11,1,0,3,16,7769
0,0,4,1,0,1,6,7771
1,0,13,0,0,4,18,7772
3,0,7,0,0,1,11,7773
2,0,12,0,0,3,17,7774
5,0,10,1,0,4,20,7775
1,0,13,1,0,3,18,7780
2,0,9,0,0,2,13,7781
5,4,8,2,1,3,23,7783
3,1,8,1,1,4,18,7784
2,0,8,0,0,4,14,7785
9,4,7,1,1,4,26,7787
2,1,8,1,1,4,17,7788
2,0,7,0,0,1,10,7789
4,0,11,1,0,4,20,7790
1,0,13,0,0,5,19,7793
2,0,7,2,1,1,13,7797
1,0,4,0,1,1,7,7799
2,0,6,0,1,1,10,7800
2,0,10,2,1,1,16,7801
3,0,9,2,1,1,16,7802
1,0,8,2,1,1,13,7803
1,0,5,0,1,1,8,7804
5,0,6,2,2,7,22,7807
1,0,6,0,1,3,11,7809
3,0,6,2,2,2,15,7810
3,0,9,2,1,1,16,7812
0,0,7,0,1,2,10,7813
1,0,4,0,1,1,7,7815
1,0,3,0,1,1,6,7816
1,0,7,2,1,1,12,7817
3,0,9,2,1,2,17,7818
3,0,9,2,1,2,17,7821
0,0,7,1,1,0,9,7822
1,0,5,1,1,1,9,7823
2,0,5,2,1,2,12,7824
4,0,10,1,1,2,18,7826
3,1,2,1,0,1,8,7827
5,1,6,0,1,4,17,7828
3,0,9,2,1,2,17,7830
2,0,8,1,1,1,13,7831
3,0,9,2,1,2,17,7832
1,0,4,0,1,1,7,7833
1,0,4,0,1,1,7,7835
1,0,4,0,1,1,7,7837
3,0,9,2,1,1,16,7839
2,3,7,0,3,6,21,7840
1,0,4,0,1,1,7,7842
1,0,4,0,1,1,7,7843
1,0,4,0,1,1,7,7844
3,0,7,4,0,2,16,7847
8,4,4,2,1,10,29,7848
3,0,7,3,0,2,15,7849
3,0,7,4,0,2,16,7850
3,0,6,6,0,2,17,7851
1,0,6,1,0,1,9,7852
3,0,6,6,0,2,17,7854
3,0,6,3,0,2,14,7855
1,2,4,0,2,2,11,7857
3,0,7,3,0,2,15,7860
5,2,4,1,0,1,13,7861
3,0,6,6,0,2,17,7862
3,0,7,3,0,2,15,7863
2,0,4,0,0,3,9,7864
1,0,4,1,0,1,7,7865
4,1,3,1,1,2,12,7867
2,0,10,1,0,8,21,7868
2,0,8,1,0,2,13,7869
3,0,7,4,0,2,16,7870
3,0,7,3,0,2,15,7871
3,0,7,4,0,2,16,7872
3,0,9,1,0,5,18,7873
3,0,9,0,0,0,12,7874
5,2,11,4,1,8,31,7876
6,3,6,1,2,8,26,7877
1,0,7,1,0,1,10,7878
1,0,9,1,0,2,13,7880
2,0,9,2,0,6,19,7881
3,0,6,6,0,2,17,7882
3,0,7,3,0,2,15,7883
5,1,6,0,1,12,25,7885
1,0,11,0,0,0,12,7887
1,0,8,2,0,2,13,7888
3,0,7,4,0,2,16,7889
4,0,10,1,0,7,22,7891
3,0,7,4,0,2,16,7893
3,0,6,6,0,2,17,7894
1,0,7,1,0,0,9,7895
2,1,8,1,0,1,13,7897
2,0,5,0,1,3,11,7898
3,1,7,4,1,5,21,7902
4,1,12,1,0,3,21,7903
4,0,11,1,0,1,17,7905
5,0,5,1,1,5,17,7906
2,1,11,0,0,3,17,7907
1,0,7,1,0,0,9,7908
3,0,9,2,0,6,20,7909
0,0,9,0,0,0,9,7910
2,1,3,0,0,0,6,7912
2,1,9,0,0,6,18,7913
1,0,13,1,0,5,20,7914
2,0,5,2,0,4,13,7915
0,0,9,1,0,1,11,7916
3,0,5,2,0,8,18,7918
2,0,9,2,0,6,19,7923
0,0,8,0,0,3,11,7924
3,0,9,1,1,9,23,7926
4,1,5,2,2,6,20,7929
2,1,8,2,0,7,20,7930
2,1,5,2,0,7,17,7932
2,3,8,1,0,3,17,7933
5,2,3,2,0,7,19,7934
0,0,6,2,0,1,9,7935
1,0,12,1,0,4,18,7936
2,0,9,2,0,6,19,7937
1,0,7,3,0,3,14,7938
0,0,1,0,1,0,2,7939
4,0,8,3,0,5,20,7940
1,0,1,1,3,1,7,7941
2,1,4,1,0,2,10,7943
4,1,7,2,4,5,23,7944
4,1,6,3,2,7,23,7945
2,2,1,0,0,1,6,7949
4,1,5,2,3,11,26,7950
3,2,6,1,0,7,19,7952
3,1,8,1,1,5,19,7953
2,1,5,1,0,8,17,7954
0,0,6,0,0,2,8,7955
2,1,5,1,0,7,16,7957
2,0,5,1,0,3,11,7958
1,0,10,0,0,2,13,7959
1,0,7,2,0,2,12,7960
0,0,17,0,0,0,17,7962
2,0,9,3,0,6,20,7963
1,0,6,2,0,2,11,7965
1,0,7,2,0,2,12,7968
1,0,7,2,0,2,12,7969
2,0,8,2,0,3,15,7970
1,0,10,3,0,3,17,7971
1,0,7,2,0,2,12,7972
1,0,7,2,0,2,12,7973
1,0,6,2,0,2,11,7976
1,0,6,2,0,2,11,7977
1,0,6,2,0,2,11,7978
4,1,6,4,2,3,20,7980
1,0,6,2,0,2,11,7981
1,0,6,2,0,2,11,7982
1,0,7,2,0,2,12,7983
1,1,1,1,1,1,6,7984
1,0,7,2,0,2,12,7987
1,0,7,2,0,2,12,7988
1,0,6,2,0,2,11,7989
1,0,7,0,1,1,10,7990
3,1,6,0,0,3,13,7991
3,1,5,2,0,7,18,7992
1,0,8,2,0,2,13,7994
1,0,7,2,0,2,12,7996
1,0,7,2,0,2,12,7999
1,0,7,2,0,2,12,8000
2,0,5,2,0,2,11,8001
1,0,6,2,0,2,11,8002
2,1,7,0,0,3,13,8003
1,0,6,2,0,2,11,8005
1,0,7,2,0,2,12,8006
3,0,7,1,0,3,14,8008
2,1,6,4,1,5,19,8009
0,0,6,0,0,3,9,8010
4,1,5,2,1,2,15,8012
2,0,4,4,0,3,13,8013
1,0,12,1,0,4,18,8015
1,0,6,2,1,2,12,8016
1,1,11,2,0,2,17,8017
2,0,4,1,0,3,10,8018
2,0,5,1,0,2,10,8019
2,0,8,1,0,2,13,8020
3,0,8,3,0,5,19,8021
4,0,7,2,0,2,15,8023
2,0,4,1,0,2,9,8024
5,0,7,4,0,2,18,8025
4,1,9,2,0,4,20,8026
2,0,4,1,0,2,9,8028
5,3,4,3,2,6,23,8029
1,0,3,1,0,1,6,8030
2,0,6,0,0,3,11,8031
3,2,7,4,1,3,20,8032
3,0,7,0,0,5,15,8034
2,0,8,1,0,2,13,8035
2,0,5,1,0,2,10,8036
3,1,5,3,0,4,16,8037
3,0,8,0,7,4,22,8038
2,0,8,2,1,3,16,8039
2,0,11,1,0,3,17,8040
2,1,9,2,1,7,22,8043
2,0,4,1,0,3,10,8044
2,0,8,1,1,4,16,8045
0,0,11,3,0,3,17,8047
2,0,4,1,0,2,9,8049
2,1,9,2,1,5,20,8055
2,0,8,1,0,2,13,8056
6,4,4,1,1,7,23,8057
1,1,15,0,0,6,23,8058
2,0,5,0,0,1,8,8060
0,0,5,0,0,2,7,8061
1,0,8,2,0,1,12,8062
0,0,11,0,0,1,12,8064
1,1,14,1,1,4,22,8065
3,1,10,1,2,8,25,8066
1,0,8,2,0,1,12,8067
1,0,9,2,0,2,14,8068
0,0,4,0,0,3,7,8069
1,0,4,0,0,4,9,8070
1,0,8,2,0,1,12,8071
1,0,8,2,0,1,12,8073
1,0,7,2,3,8,21,8074
3,0,12,2,0,3,20,8079
2,0,6,1,0,2,11,8081
1,0,4,0,0,1,6,8083
0,0,11,0,0,1,12,8084
2,1,12,1,1,4,21,8085
1,0,6,2,0,1,10,8087
5,2,3,1,0,2,13,8088
2,0,8,0,0,3,13,8089
1,0,8,2,0,1,12,8091
5,6,7,0,0,7,25,8094
1,0,6,0,0,1,8,8095
2,0,7,0,0,3,12,8096
2,0,4,0,0,1,7,8097
4,4,9,0,0,12,29,8098
5,1,7,1,1,4,19,8100
2,0,8,1,0,0,11,8101
2,3,12,0,0,2,19,8102
4,1,9,1,0,4,19,8103
3,0,1,0,2,2,8,8105
2,0,4,0,0,1,7,8106
4,0,8,1,1,8,22,8109
1,0,3,0,0,2,6,8110
2,0,5,0,1,1,9,8111
1,1,7,1,0,1,11,8112
1,0,5,0,0,1,7,8113
3,1,4,3,0,5,16,8116
2,1,12,1,0,4,20,8118
5,0,11,1,0,7,24,8119
5,4,2,0,3,7,21,8120
3,2,3,3,3,4,18,8121
2,0,9,1,0,2,14,8122
2,1,3,0,2,2,10,8125
1,0,6,0,0,1,8,8126
2,0,6,0,0,5,13,8128
1,1,10,1,0,2,15,8129
2,1,4,1,0,3,11,8130
2,0,3,0,0,2,7,8131
3,0,4,0,0,4,11,8133
4,5,7,0,2,5,23,8135
6,4,9,1,0,6,26,8136
4,1,8,1,0,5,19,8137
0,0,12,1,0,3,16,8138
1,0,10,4,0,4,19,8140
2,0,4,0,0,1,7,8141
3,0,9,0,0,8,20,8142
3,0,9,0,0,8,20,8143
3,0,9,0,0,8,20,8144
3,0,9,0,0,8,20,8146
3,0,9,0,0,8,20,8147
3,0,9,1,0,7,20,8149
2,0,8,1,0,6,17,8150
3,1,2,1,0,3,10,8154
2,0,9,1,0,6,18,8155
5,0,7,2,0,9,23,8156
3,0,10,0,0,10,23,8158
2,0,10,0,0,2,14,8159
3,0,9,0,0,8,20,8161
3,0,9,0,0,8,20,8162
3,0,10,0,0,10,23,8163
3,0,9,0,0,8,20,8164
0,0,17,2,0,1,20,8165
3,0,10,0,0,10,23,8168
3,0,12,0,0,6,21,8169
3,0,9,0,0,8,20,8170
3,0,9,1,0,5,18,8171
4,0,9,1,0,7,21,8172
4,0,9,1,1,11,26,8175
3,0,8,1,0,7,19,8176
3,0,9,0,0,8,20,8177
3,0,9,0,0,8,20,8180
4,3,6,1,1,4,19,8181
3,0,8,1,1,7,20,8182
3,0,10,0,0,10,23,8183
2,0,9,0,0,2,13,8184
3,0,9,2,1,7,22,8187
2,0,5,0,0,1,8,8188
1,0,9,1,0,4,15,8189
3,0,9,2,1,7,22,8190
3,0,9,0,0,9,21,8191
3,1,9,2,0,6,21,8195
0,0,10,0,0,1,11,8196
1,1,2,0,0,1,5,8201
2,0,10,2,0,2,16,8202
0,0,9,1,0,5,15,8203
1,0,8,3,0,1,13,8204
0,0,6,1,0,5,12,8205
3,1,4,1,1,6,16,8208
5,0,7,2,1,5,20,8209
3,1,9,1,0,6,20,8210
1,0,3,0,0,3,7,8211
2,1,6,2,0,3,14,8212
1,0,15,1,0,3,20,8213
2,0,10,2,0,2,16,8214
1,1,8,1,0,2,13,8215
1,0,14,1,0,3,19,8216
2,3,11,0,0,1,17,8217
0,0,7,1,0,5,13,8218
2,0,5,1,1,5,14,8219
1,1,7,1,0,1,11,8221
3,2,10,0,0,6,21,8223
6,1,6,0,2,5,20,8224
2,1,4,1,1,7,16,8225
7,2,7,1,1,7,25,8226
3,1,9,2,0,3,18,8231
1,0,7,1,0,6,15,8232
4,3,5,2,1,6,21,8234
3,1,11,0,2,6,23,8235
0,0,15,0,0,1,16,8236
4,0,3,2,0,5,14,8237
0,0,10,0,0,1,11,8238
4,0,11,1,0,4,20,8239
2,0,10,2,0,2,16,8240
1,0,4,0,0,0,5,8241
4,0,4,1,3,6,18,8242
1,0,14,1,0,7,23,8243
4,0,6,1,0,5,16,8244
2,1,3,0,0,2,8,8245
5,2,5,1,1,4,18,8246
3,0,4,1,1,2,11,8247
2,0,7,1,1,5,16,8250
3,0,2,1,0,6,12,8251
3,0,8,0,1,7,19,8252
3,3,4,1,0,7,18,8253
1,0,7,1,0,1,10,8254
0,0,10,2,0,3,15,8256
4,1,3,0,1,7,16,8257
3,0,5,1,2,4,15,8258
3,3,5,3,0,8,22,8259
5,0,10,2,0,7,24,8261
3,0,8,2,1,6,20,8262
6,2,3,1,0,4,16,8264
5,0,11,2,0,6,24,8266
1,0,1,0,1,2,5,8267
0,0,4,1,0,0,5,8270
2,2,5,0,0,2,11,8271
3,0,11,2,0,8,24,8274
0,0,5,2,0,4,11,8276
5,1,3,1,0,3,13,8278
5,0,10,3,1,6,25,8279
5,1,5,1,2,6,20,8280
7,3,7,1,1,6,25,8283
3,0,7,0,5,8,23,8284
1,0,5,2,2,2,12,8285
3,2,3,1,1,3,13,8286
4,0,8,0,1,5,18,8287
1,0,7,1,0,1,10,8288
5,0,10,2,0,5,22,8289
8,2,6,0,1,6,23,8291
6,1,5,1,0,6,19,8292
1,0,14,1,0,5,21,8294
6,2,5,2,0,8,23,8295
2,0,14,1,0,2,19,8296
2,0,14,1,0,2,19,8297
6,5,5,1,3,4,24,8298
3,1,6,1,0,8,19,8300
1,0,8,0,0,3,12,8301
1,0,17,1,0,4,23,8304
2,0,8,0,0,3,13,8309
3,0,16,0,0,5,24,8310
7,3,3,2,1,5,21,8311
1,0,7,0,0,3,11,8312
1,0,8,0,0,3,12,8314
1,0,10,1,0,10,22,8315
1,0,8,0,0,3,12,8317
2,0,10,3,0,4,19,8318
1,0,10,0,0,3,14,8320
1,0,15,1,0,5,22,8321
1,1,2,0,0,3,7,8324
1,0,7,1,0,3,12,8329
1,0,9,0,0,3,13,8330
1,0,10,0,0,3,14,8332
1,0,8,0,0,3,12,8334
1,0,9,0,0,4,14,8335
3,0,13,1,0,4,21,8337
1,0,4,0,0,2,7,8339
1,0,8,0,0,3,12,8341
5,3,8,1,1,5,23,8344
4,4,3,0,1,2,14,8345
1,1,1,0,0,0,3,8346
2,2,4,0,0,0,8,8347
4,5,8,3,2,5,27,8348
1,0,3,1,0,2,7,8349
1,2,5,1,0,2,11,8350
2,0,5,3,1,2,13,8351
2,1,2,0,0,0,5,8352
4,7,7,0,0,5,23,8355
2,1,5,3,1,5,17,8356
4,2,6,2,1,2,17,8360
2,1,2,1,0,0,6,8361
3,2,3,2,2,5,17,8362
0,0,9,0,0,2,11,8363
2,0,3,0,0,6,11,8364
3,2,3,1,2,3,14,8365
4,3,5,0,0,4,16,8366
2,2,3,1,1,4,13,8367
0,1,18,0,0,1,20,8368
2,0,3,0,0,3,8,8369
3,7,6,1,0,3,20,8370
5,2,2,1,1,4,15,8371
2,2,2,0,2,2,10,8372
0,0,4,0,1,1,6,8374
4,0,8,4,0,7,23,8375
2,1,3,1,0,1,8,8377
4,0,7,1,0,6,18,8378
1,0,4,1,0,2,8,8382
1,0,8,1,0,1,11,8383
4,3,4,2,1,3,17,8385
2,3,2,2,0,3,12,8386
5,2,9,1,0,9,26,8387
4,3,1,2,1,2,13,8388
3,4,8,3,1,4,23,8389
2,2,2,0,0,2,8,8390
2,3,4,0,0,1,10,8391
2,0,4,1,1,4,12,8392
1,0,9,0,0,4,14,8393
1,0,9,0,0,4,14,8394
4,2,7,5,2,5,25,8396
1,0,9,0,0,4,14,8397
1,1,4,1,0,1,8,8399
1,0,9,0,0,4,14,8400
1,0,9,0,0,4,14,8401
1,0,9,0,0,4,14,8402
1,0,9,0,0,4,14,8404
1,0,9,0,0,4,14,8405
2,0,12,1,0,6,21,8406
0,0,3,0,0,0,3,8408
1,0,9,0,0,4,14,8409
1,0,9,0,0,4,14,8410
1,0,9,0,0,4,14,8411
1,0,9,0,0,4,14,8412
1,1,6,0,0,2,10,8414
0,0,12,1,0,4,17,8415
1,0,9,0,0,4,14,8416
1,0,9,0,0,4,14,8418
1,0,9,0,0,4,14,8419
1,0,9,0,0,4,14,8422
1,0,9,0,0,4,14,8423
1,0,4,1,2,4,12,8425
1,0,9,0,0,4,14,8428
1,0,9,0,0,4,14,8429
1,0,3,0,0,0,4,8430
1,0,9,0,0,4,14,8431
1,0,9,0,0,4,14,8432
1,0,9,0,0,4,14,8433
1,0,7,3,0,7,18,8434
1,0,9,0,0,4,14,8435
1,1,6,1,0,0,9,8436
3,1,3,0,1,2,10,8437
1,0,6,0,1,0,8,8440
1,0,9,0,0,4,14,8441
2,2,3,0,1,3,11,8443
2,3,3,2,1,3,14,8444
6,3,4,3,2,4,22,8445
2,0,5,1,0,3,11,8446
2,2,5,0,0,0,9,8447
4,4,7,0,0,8,23,8448
5,1,14,1,0,2,23,8450
5,3,5,2,1,4,20,8451
3,3,7,2,0,8,23,8452
2,0,3,1,0,1,7,8453
1,0,11,0,0,2,14,8454
3,2,4,2,1,2,14,8455
4,4,3,1,5,8,25,8457
5,3,2,0,2,7,19,8458
6,5,2,0,0,1,14,8459
3,0,7,3,1,7,21,8461
3,1,4,0,2,5,15,8463
7,1,6,1,0,7,22,8464
5,2,6,0,2,6,21,8468
5,3,10,1,0,7,26,8471
2,3,8,1,1,4,19,8472
5,1,6,1,2,8,23,8473
5,3,8,1,3,6,26,8475
2,1,5,1,1,1,11,8476
1,1,7,0,0,1,10,8477
2,1,1,1,2,0,7,8478
0,1,5,0,0,1,7,8480
1,1,20,1,0,2,25,8483
2,1,3,0,0,2,8,8484
2,1,7,0,1,4,15,8486
2,2,2,0,1,2,9,8487
0,1,4,0,0,0,5,8489
1,0,6,1,0,0,8,8490
7,0,6,1,3,7,24,8491
2,2,2,0,0,3,9,8494
3,2,3,1,1,6,16,8496
0,0,8,0,0,0,8,8497
5,4,6,1,1,11,28,8498
1,0,2,0,1,1,5,8500
0,0,6,0,0,0,6,8502
0,0,2,0,0,0,2,8503
0,0,4,0,1,0,5,8504
5,1,10,2,1,2,21,8505
0,0,4,0,0,0,4,8506
4,0,2,0,0,0,6,8507
2,1,2,1,1,2,9,8508
2,1,5,2,0,2,12,8509
2,0,12,0,1,5,20,8510
0,1,7,0,0,0,8,8511
0,0,3,0,0,0,3,8512
0,0,2,0,0,0,2,8513
0,0,10,0,0,0,10,8514
4,3,6,1,2,5,21,8515
1,2,6,3,2,4,18,8516
5,2,12,0,1,7,27,8517
3,2,3,1,2,5,16,8518
0,0,7,1,0,0,8,8520
2,2,3,0,0,0,7,8522
0,0,3,0,0,1,4,8523
2,0,2,1,0,5,10,8524
4,5,6,0,1,4,20,8526
0,0,3,0,0,0,3,8528
6,4,5,0,1,8,24,8530
0,0,3,0,0,0,3,8531
0,0,6,1,0,0,7,8533
0,0,4,0,0,0,4,8536
0,0,5,0,0,1,6,8538
2,1,6,0,0,0,9,8539
3,4,10,3,0,9,29,8540
0,0,4,1,0,0,5,8541
1,1,4,1,0,0,7,8542
1,0,2,1,0,1,5,8543
0,0,6,1,0,2,9,8545
2,2,5,1,1,9,20,8546
1,0,2,2,0,2,7,8547
1,0,1,1,1,0,4,8550
1,0,2,1,0,0,4,8551
5,3,10,1,1,7,27,8553
3,2,7,2,1,8,23,8555
6,2,4,1,0,4,17,8556
1,3,4,0,3,3,14,8557
2,2,4,1,0,1,10,8558
0,0,5,0,0,4,9,8559
1,1,3,0,1,1,7,8560
0,0,4,0,0,2,6,8561
0,1,5,0,1,7,14,8562
1,0,3,0,0,0,4,8567
5,1,8,1,0,1,16,8570
1,0,5,2,0,3,11,8571
2,1,5,1,1,1,11,8572
4,1,4,2,0,7,18,8574
3,3,3,1,2,2,14,8575
1,1,4,0,0,2,8,8576
8,6,7,1,1,7,30,8577
3,3,6,3,1,6,22,8578
1,1,6,1,0,3,12,8579
0,0,7,2,0,1,10,8580
3,2,9,1,2,8,25,8581
2,1,2,0,1,3,9,8582
4,5,5,1,2,6,23,8584
1,0,5,0,0,2,8,8585
2,2,8,3,0,9,24,8586
1,1,8,2,2,2,16,8587
0,0,2,1,0,0,3,8589
0,0,6,0,0,0,6,8591
0,0,4,0,0,1,5,8595
4,2,8,4,0,5,23,8596
0,0,9,0,0,3,12,8598
2,1,4,4,2,10,23,8599
2,0,4,1,0,2,9,8606
4,0,7,2,0,7,20,8607
1,0,8,1,0,2,12,8608
0,0,9,2,0,4,15,8609
1,0,10,0,0,5,16,8610
4,1,7,3,0,3,18,8612
0,0,12,1,0,5,18,8613
0,0,12,3,0,6,21,8615
0,0,11,0,0,1,12,8618
1,0,8,3,0,6,18,8620
1,1,6,0,0,5,13,8621
2,2,6,1,0,7,18,8622
0,0,11,0,0,3,14,8623
2,0,9,2,0,4,17,8624
0,0,12,3,0,6,21,8625
1,0,4,1,0,1,7,8627
4,2,9,0,1,4,20,8628
1,0,6,2,0,3,12,8631
1,0,7,0,0,2,10,8633
0,0,8,1,0,3,12,8635
0,0,6,1,0,1,8,8636
1,0,18,0,1,7,27,8637
7,0,11,2,0,7,27,8638
0,0,8,0,0,3,11,8639
1,0,5,2,0,3,11,8640
2,2,8,2,0,2,16,8642
2,3,9,1,0,5,20,8643
6,1,5,3,3,7,25,8644
4,1,3,2,1,3,14,8646
0,0,10,4,0,1,15,8647
0,0,6,2,0,0,8,8648
0,0,6,1,0,1,8,8650
1,0,5,2,0,2,10,8651
4,0,6,0,0,5,15,8653
2,0,5,0,0,2,9,8654
2,0,10,2,0,6,20,8655
0,0,9,0,1,3,13,8656
0,0,8,2,0,1,11,8657
4,1,7,2,1,7,22,8658
1,1,6,1,0,2,11,8659
3,0,4,3,1,4,15,8660
0,0,8,0,0,2,10,8661
1,0,10,1,0,1,13,8662
1,0,8,3,0,2,14,8663
0,0,5,1,0,1,7,8664
0,0,11,2,0,0,13,8665
0,0,8,0,0,2,10,8667
0,0,7,0,0,0,7,8668
0,0,8,1,0,0,9,8669
4,1,3,0,1,6,15,8670
1,0,2,0,0,2,5,8673
0,0,7,2,0,0,9,8674
0,0,12,3,0,5,20,8676
1,1,9,2,0,2,15,8677
4,0,9,2,0,4,19,8680
2,1,5,0,0,5,13,8681
1,0,5,1,0,2,9,8683
1,0,5,2,0,0,8,8684
6,2,5,1,0,5,19,8685
1,0,7,0,0,4,12,8686
1,0,3,1,1,4,10,8688
3,0,9,3,0,8,23,8689
1,0,2,0,0,2,5,8690
0,0,13,2,0,1,16,8691
5,2,4,1,0,3,15,8692
0,0,8,1,0,2,11,8693
5,2,3,1,0,3,14,8694
3,4,10,1,0,7,25,8695
4,5,7,2,2,4,24,8696
3,0,7,0,1,3,14,8697
4,4,6,2,1,10,27,8698
2,2,4,0,1,4,13,8699
5,1,7,0,1,9,23,8700
4,4,6,2,1,10,27,8702
2,1,8,1,0,4,16,8704
0,0,6,3,0,1,10,8705
4,4,6,2,1,10,27,8706
4,0,3,0,1,5,13,8708
1,0,11,0,0,0,12,8709
1,1,7,1,0,4,14,8710
1,1,3,0,0,3,8,8711
2,0,10,0,0,2,14,8712
4,4,6,2,1,10,27,8714
3,1,5,1,0,10,20,8715
1,2,10,2,1,6,22,8717
3,1,10,0,1,9,24,8718
6,0,5,1,1,4,17,8720
5,2,4,1,0,3,15,8721
1,0,14,1,0,2,18,8722
3,1,6,0,0,2,12,8723
2,0,3,0,0,4,9,8724
6,6,6,0,3,5,26,8726
4,4,6,2,1,10,27,8727
3,4,6,4,3,10,30,8728
3,1,7,2,0,3,16,8729
4,4,4,1,0,3,16,8732
3,1,8,1,2,7,22,8733
5,2,3,1,0,3,14,8734
4,4,6,2,1,10,27,8735
1,0,13,0,0,1,15,8736
2,0,1,0,1,0,4,8737
4,1,3,2,3,5,18,8738
4,4,6,2,1,10,27,8739
3,2,1,0,1,2,9,8740
5,2,3,1,0,3,14,8741
3,2,3,2,2,3,15,8742
1,1,8,0,1,0,11,8743
4,0,11,2,0,6,23,8744
1,0,0,1,0,1,3,8745
0,0,3,1,0,0,4,8746
0,0,9,0,0,4,13,8747
3,1,10,1,1,3,19,8750
0,1,2,0,0,1,4,8751
3,0,7,4,4,8,26,8752
1,1,9,1,0,11,23,8753
0,0,11,1,0,3,15,8754
1,1,4,3,0,2,11,8755
1,0,7,0,0,1,9,8757
4,1,6,1,3,3,18,8758
0,0,4,1,0,1,6,8759
5,0,8,5,2,7,27,8760
4,2,5,1,1,6,19,8761
10,2,3,0,3,7,25,8762
1,0,5,3,0,3,12,8763
4,1,3,0,1,0,9,8766
3,1,6,0,1,2,13,8767
2,1,6,1,0,6,16,8768
3,2,9,5,1,7,27,8770
2,2,9,2,4,2,21,8774
2,2,7,1,2,6,20,8775
1,0,5,1,0,5,12,8776
7,3,6,0,2,10,28,8777
0,0,3,1,2,2,8,8778
3,0,3,2,0,5,13,8780
3,5,3,0,0,1,12,8781
3,0,3,1,0,1,8,8782
0,0,4,0,0,1,5,8783
1,0,4,0,0,2,7,8784
7,0,8,0,0,9,24,8785
4,2,6,0,0,6,18,8786
4,4,7,1,2,8,26,8787
1,0,1,1,1,2,6,8788
3,2,1,1,1,4,12,8789
5,2,3,0,3,7,20,8790
3,2,5,0,0,4,14,8791
6,1,11,1,0,4,23,8793
1,0,7,1,0,5,14,8795
7,3,8,1,1,5,25,8797
2,0,12,0,0,4,18,8799
4,1,2,1,0,5,13,8800
1,0,2,0,0,1,4,8801
3,2,2,2,2,4,15,8802
4,0,5,0,0,1,10,8804
0,0,2,0,0,1,3,8805
3,0,1,0,0,2,6,8806
4,2,5,1,0,5,17,8808
3,0,9,0,1,7,20,8810
2,3,2,0,0,4,11,8812
1,0,12,1,0,5,19,8815
6,2,7,2,1,4,22,8816
0,0,3,0,0,0,3,8817
0,0,13,1,0,3,17,8823
5,0,9,0,0,5,19,8825
2,0,2,0,0,0,4,8829
2,3,2,0,0,5,12,8830
1,0,7,0,0,3,11,8831
4,2,9,2,0,2,19,8832
1,0,6,1,0,8,16,8835
1,0,5,0,0,7,13,8836
1,0,13,0,0,2,16,8837
1,1,6,1,0,3,12,8838
2,0,3,1,0,1,7,8839
4,1,3,1,0,6,15,8840
0,0,11,1,0,7,19,8841
0,0,3,3,1,3,10,8842
1,2,4,0,0,2,9,8843
3,2,2,0,1,2,10,8844
1,1,1,0,0,1,4,8846
0,0,7,0,0,1,8,8848
7,3,9,1,0,6,26,8850
2,4,6,1,1,6,20,8851
1,2,11,1,3,2,20,8852
1,0,10,0,0,1,12,8853
4,2,4,1,0,8,19,8854
2,1,0,0,0,1,4,8855
3,2,3,0,1,6,15,8856
3,1,0,0,0,3,7,8857
8,5,3,0,1,2,19,8858
3,1,8,1,1,3,17,8859
2,1,1,2,0,2,8,8860
2,0,3,0,0,0,5,8862
10,3,5,0,0,8,26,8863
0,0,9,1,1,2,13,8864
3,2,2,1,1,5,14,8865
5,3,5,1,2,4,20,8866
1,0,3,1,0,2,7,8869
2,1,3,0,0,3,9,8871
2,2,6,3,0,6,19,8872
3,2,5,1,2,5,18,8875
1,1,1,0,0,1,4,8878
2,2,2,0,0,2,8,8880
4,3,8,3,0,5,23,8881
5,3,1,0,2,3,14,8883
0,0,3,0,0,0,3,8885
4,2,4,1,0,2,13,8886
4,2,10,4,0,6,26,8887
5,2,6,1,1,4,19,8888
3,1,2,0,1,3,10,8890
2,0,4,0,0,5,11,8892
2,1,4,1,1,2,11,8893
6,2,11,0,0,9,28,8896
4,1,6,3,1,11,26,8899
2,2,12,1,1,3,21,8900
2,0,11,0,0,1,14,8902
4,4,0,1,0,1,10,8903
2,0,11,0,0,5,18,8905
2,0,4,3,0,4,13,8906
0,0,17,0,0,0,17,8907
0,0,12,0,1,2,15,8908
2,0,11,0,0,1,14,8912
2,0,4,0,1,3,10,8913
2,1,6,1,1,6,17,8914
3,1,11,3,1,2,21,8916
2,2,5,1,0,3,13,8920
0,0,6,0,0,5,11,8921
3,1,13,2,0,8,27,8923
2,0,11,0,0,1,14,8924
1,1,3,1,1,3,10,8926
6,1,7,2,1,10,27,8927
2,0,8,2,2,3,17,8931
1,0,12,0,0,4,17,8933
1,1,11,1,0,5,19,8934
3,1,5,2,1,2,14,8935
0,0,20,1,0,0,21,8936
3,1,13,3,1,13,34,8938
2,0,10,2,2,7,23,8939
3,0,11,4,0,3,21,8941
0,0,1,0,0,2,3,8942
2,0,11,0,1,5,19,8944
2,0,8,2,0,4,16,8945
2,2,2,1,2,5,14,8946
1,1,1,0,2,1,6,8947
0,0,15,1,0,1,17,8948
1,1,4,0,0,4,10,8949
4,0,12,0,0,8,24,8952
2,1,2,1,0,4,10,8953
1,3,6,2,1,8,21,8955
0,0,9,0,0,4,13,8956
3,2,6,1,0,6,18,8957
3,0,5,3,0,6,17,8959
1,0,7,1,0,3,12,8961
3,3,4,0,0,5,15,8962
1,0,10,0,0,0,11,8963
5,2,5,0,0,5,17,8965
2,1,3,1,0,1,8,8966
0,0,19,1,0,1,21,8967
0,0,1,0,0,1,2,8968
0,0,3,1,0,2,6,8969
3,0,7,1,0,5,16,8970
4,0,9,2,0,5,20,8971
2,0,7,1,0,3,13,8972
1,1,5,1,1,2,11,8973
0,0,1,1,0,2,4,8974
3,0,10,3,0,3,19,8976
1,0,9,0,0,0,10,8978
0,0,19,0,0,1,20,8979
5,1,3,0,1,4,14,8980
3,3,3,4,1,2,16,8983
3,1,4,1,1,3,13,8985
3,1,7,2,1,10,24,8986
0,0,9,0,0,1,10,8987
5,2,12,2,0,6,27,8989
3,1,7,2,0,4,17,8992
2,0,4,2,0,4,12,8993
0,0,13,1,0,1,15,8994
2,1,3,2,1,1,10,8996
5,2,9,0,0,8,24,8998
2,1,8,1,0,7,19,8999
2,0,5,1,1,5,14,9000
3,1,2,3,1,3,13,9001
1,0,5,0,1,0,7,9002
0,0,10,2,0,2,14,9005
0,0,4,0,0,4,8,9006
0,0,10,2,0,4,16,9007
1,0,4,1,2,1,9,9008
2,0,2,0,0,3,7,9009
4,2,5,1,0,0,12,9012
2,0,3,1,0,8,14,9016
0,0,4,0,0,0,4,9018
0,0,11,0,0,2,13,9020
3,1,2,2,1,0,9,9022
5,1,6,1,0,6,19,9023
2,0,2,2,1,1,8,9025
4,0,3,0,0,4,11,9026
4,2,3,1,1,3,14,9027
0,0,12,0,1,1,14,9028
1,1,15,1,0,0,18,9029
0,0,7,0,0,2,9,9030
3,1,5,1,1,4,15,9031
4,2,5,1,1,6,19,9033
4,0,10,1,2,9,26,9034
3,1,2,3,1,3,13,9038
2,2,5,1,0,4,14,9039
1,2,4,0,1,2,10,9040
0,0,11,0,0,2,13,9041
4,0,9,2,0,7,22,9042
0,0,8,1,0,1,10,9044
1,1,6,2,1,5,16,9045
1,0,6,3,0,1,11,9047
5,0,13,1,0,2,21,9051
4,0,8,1,0,4,17,9052
3,0,8,3,0,4,18,9053
1,0,7,2,0,2,12,9054
2,0,6,2,0,5,15,9055
2,0,6,2,0,4,14,9057
3,1,7,3,1,2,17,9058
1,0,7,4,0,1,13,9059
1,0,8,2,0,1,12,9060
3,0,10,3,0,4,20,9061
3,2,8,3,0,6,22,9062
1,0,9,2,0,2,14,9064
1,0,11,3,0,3,18,9067
4,0,8,1,0,4,17,9071
2,0,3,2,0,2,9,9072
4,0,8,1,0,4,17,9074
5,0,9,1,0,5,20,9075
5,1,6,1,0,7,20,9077
3,0,10,1,0,7,21,9078
3,2,7,1,0,6,19,9079
1,1,3,1,0,1,7,9080
3,1,4,2,3,4,17,9081
2,0,10,2,0,3,17,9082
3,0,8,3,0,4,18,9083
1,0,6,4,2,7,20,9084
5,1,8,4,0,7,25,9085
2,0,3,2,0,2,9,9086
1,0,9,3,0,4,17,9087
2,0,7,2,0,2,13,9088
3,0,8,2,0,2,15,9089
4,0,9,3,0,5,21,9090
6,0,10,1,2,3,22,9093
5,2,8,0,1,9,25,9094
4,1,8,2,0,2,17,9095
2,1,10,1,0,3,17,9096
2,1,10,1,0,3,17,9097
4,1,8,2,0,2,17,9098
4,2,3,1,2,4,16,9099
2,1,10,1,0,3,17,9100
2,1,9,1,0,3,16,9101
3,1,15,1,0,3,23,9102
4,0,7,3,3,6,23,9103
1,0,2,0,0,1,4,9106
4,1,8,2,0,2,17,9107
2,1,10,1,0,3,17,9109
2,1,12,1,0,4,20,9110
3,1,12,3,0,4,23,9112
4,1,8,2,0,2,17,9113
4,1,8,2,0,2,17,9114
3,1,12,3,0,4,23,9116
2,1,11,1,0,3,18,9118
1,0,16,0,0,3,20,9119
2,1,8,1,0,2,14,9120
2,1,8,1,0,2,14,9121
2,1,8,1,0,2,14,9123
2,1,10,1,0,3,17,9124
2,1,12,2,0,6,23,9126
2,1,9,1,0,3,16,9128
1,0,10,0,0,0,11,9130
3,1,14,1,0,3,22,9131
2,1,8,1,0,2,14,9132
2,1,10,1,0,4,18,9134
4,1,8,2,0,2,17,9135
2,0,17,1,0,5,25,9137
1,1,11,1,0,2,16,9139
2,1,11,1,0,3,18,9141
0,0,9,0,0,2,11,9142
0,0,9,0,0,2,11,9143
3,0,8,2,0,7,20,9144
2,0,7,0,0,1,10,9145
0,0,8,0,0,2,10,9146
1,0,6,0,0,1,8,9148
1,0,11,0,1,4,17,9149
0,1,6,3,1,4,15,9151
0,0,14,0,0,3,17,9154
0,0,9,0,0,3,12,9156
1,0,8,0,1,2,12,9157
3,0,10,2,1,4,20,9159
2,0,10,4,0,4,20,9161
0,0,6,0,0,1,7,9162
2,0,6,0,1,2,11,9164
1,0,11,2,0,8,22,9166
1,0,8,0,0,2,11,9169
1,0,8,0,0,2,11,9171
1,0,9,7,0,5,22,9172
2,0,8,0,0,2,12,9173
1,0,8,0,1,2,12,9174
3,0,11,1,0,3,18,9175
0,0,5,0,0,2,7,9177
0,0,9,0,0,2,11,9179
4,0,9,0,0,5,18,9180
4,0,6,2,0,10,22,9181
1,1,11,1,0,4,18,9182
3,0,11,0,0,4,18,9183
3,0,11,1,0,3,18,9185
0,0,9,0,0,2,11,9187
1,0,8,0,0,2,11,9191
6,2,3,3,2,7,23,9192
2,0,12,1,0,9,24,9193
2,1,7,1,0,2,13,9194
1,0,11,2,1,5,20,9195
3,2,11,0,1,3,20,9197
0,0,9,1,0,4,14,9203
2,0,3,0,2,2,9,9206
2,0,6,0,0,2,10,9207
5,1,3,2,3,3,17,9208
2,0,7,0,0,2,11,9209
1,0,5,2,0,2,10,9210
2,0,9,1,0,8,20,9211
3,0,9,2,0,5,19,9212
2,1,9,3,0,9,24,9215
1,0,3,1,0,1,6,9216
0,0,10,1,0,4,15,9217
6,2,5,3,1,5,22,9218
1,0,5,2,0,2,10,9219
1,0,5,2,0,2,10,9220
4,1,9,0,1,6,21,9221
3,1,6,0,2,4,16,9222
3,0,10,0,0,7,20,9223
2,0,6,0,0,2,10,9225
2,0,11,1,0,8,22,9226
0,0,7,0,0,1,8,9230
2,1,13,0,0,5,21,9231
3,2,5,1,0,4,15,9232
5,0,8,0,0,7,20,9233
1,0,5,2,0,2,10,9235
4,2,5,1,1,7,20,9237
2,0,12,1,0,7,22,9238
2,0,10,1,0,7,20,9239
1,0,5,2,0,6,14,9240
2,0,13,1,0,4,20,9242
2,1,5,1,3,3,15,9244
5,3,4,0,0,6,18,9246
1,0,7,4,0,4,16,9247
1,1,5,1,0,4,12,9248
1,0,17,0,0,0,18,9249
4,2,7,2,1,2,18,9250
5,2,5,1,2,10,25,9251
2,4,5,1,1,3,16,9252
4,0,3,0,0,5,12,9253
4,3,4,0,4,5,20,9254
0,0,13,0,0,1,14,9255
3,5,4,1,0,3,16,9257
1,1,9,1,2,8,22,9259
4,1,19,3,1,4,32,9260
0,0,3,1,1,1,6,9262
5,1,7,0,1,8,22,9263
2,2,3,0,2,2,11,9264
4,4,6,2,2,4,22,9265
5,3,7,4,0,5,24,9266
3,1,4,0,3,8,19,9267
5,1,6,2,1,9,24,9268
2,2,2,1,2,1,10,9269
3,1,3,1,0,3,11,9270
6,3,3,1,4,8,25,9271
2,1,4,0,0,2,9,9272
1,0,8,0,0,0,9,9273
7,3,8,1,2,6,27,9275
1,0,17,0,0,0,18,9276
6,1,6,2,1,7,23,9277
6,7,8,0,0,7,28,9278
5,2,9,1,0,3,20,9280
2,0,3,0,0,2,7,9281
1,3,2,0,2,3,11,9283
0,1,5,2,1,0,9,9286
5,4,7,3,0,4,23,9287
6,3,7,0,1,10,27,9288
1,0,4,0,2,4,11,9289
1,0,11,1,0,7,20,9290
0,0,10,1,0,4,15,9292
5,0,6,2,0,2,15,9293
4,1,4,2,2,5,18,9294
3,2,3,2,0,1,11,9296
4,2,5,0,0,4,15,9297
0,0,9,0,0,3,12,9298
4,0,8,0,0,4,16,9300
3,2,3,1,1,4,14,9301
2,1,4,3,0,5,15,9303
1,1,0,1,0,3,6,9307
3,2,1,1,0,2,9,9308
3,0,8,0,1,3,15,9309
0,0,15,0,0,0,15,9311
6,3,3,1,0,9,22,9313
1,0,2,0,0,2,5,9314
2,1,5,1,0,3,12,9315
3,2,7,3,1,5,21,9317
3,2,3,1,0,6,15,9319
2,1,9,0,0,3,15,9320
9,4,3,1,1,10,28,9321
4,1,1,0,3,2,11,9322
3,1,8,0,0,5,17,9324
3,0,9,0,0,5,17,9325
0,0,2,0,0,0,2,9329
8,5,2,1,2,6,24,9330
3,1,8,2,0,3,17,9332
3,0,1,0,0,3,7,9333
3,3,6,2,1,6,21,9334
0,0,6,1,0,1,8,9337
2,2,2,0,0,1,7,9338
1,0,7,0,0,1,9,9339
0,0,10,0,0,5,15,9341
4,1,6,3,0,5,19,9342
3,1,5,1,0,5,15,9343
4,3,9,0,1,5,22,9344
5,4,4,1,1,6,21,9345
6,5,5,1,3,7,27,9346
1,1,2,1,0,0,5,9347
2,1,5,0,0,3,11,9348
1,0,6,1,0,2,10,9350
4,2,6,2,0,14,28,9351
6,4,5,0,2,6,23,9355
3,1,6,2,3,9,24,9360
3,0,5,1,3,4,16,9361
2,0,3,1,2,3,11,9362
0,0,9,1,0,0,10,9363
2,0,5,1,1,4,13,9365
2,1,5,2,0,2,12,9367
1,1,9,2,0,5,18,9368
2,1,3,0,0,5,11,9371
2,1,8,3,0,5,19,9372
3,2,0,0,1,1,7,9373
2,1,4,0,1,7,15,9374
5,2,8,1,2,6,24,9375
4,0,9,1,1,5,20,9376
1,1,5,0,0,3,10,9377
5,2,9,1,1,2,20,9378
4,2,8,2,1,11,28,9380
6,2,7,1,1,4,21,9382
4,3,4,2,2,4,19,9384
2,0,11,0,0,5,18,9385
2,1,8,2,1,5,19,9386
5,3,1,0,1,4,14,9387
1,0,3,2,0,0,6,9388
2,1,8,1,0,3,15,9391
0,0,8,0,0,3,11,9393
2,0,2,1,0,3,8,9395
1,0,8,1,0,1,11,9396
1,1,8,2,0,6,18,9397
0,0,7,4,0,3,14,9401
4,0,7,3,1,5,20,9402
2,0,4,0,0,1,7,9403
3,0,13,1,1,2,20,9404
2,0,3,0,0,1,6,9405
1,0,8,1,0,1,11,9406
1,0,2,1,0,0,4,9408
2,0,13,0,0,5,20,9410
7,5,6,2,0,4,24,9411
1,0,11,1,0,2,15,9414
2,0,5,0,0,1,8,9416
2,2,7,0,2,1,14,9417
6,0,5,2,1,9,23,9418
0,0,11,0,0,1,12,9420
1,0,8,1,0,1,11,9421
4,0,3,4,2,8,21,9422
3,1,3,1,1,6,15,9425
3,2,6,4,1,6,22,9430
2,1,16,3,0,3,25,9431
0,0,8,0,0,3,11,9432
2,0,10,2,1,6,21,9434
3,0,10,2,0,5,20,9435
2,1,9,2,0,6,20,9436
2,0,3,0,0,1,6,9438
0,0,8,1,0,3,12,9439
0,0,4,0,0,0,4,9441
2,0,9,2,0,0,13,9445
0,0,8,1,1,2,12,9446
4,0,6,0,0,3,13,9448
2,0,9,2,0,0,13,9449
2,0,4,0,0,0,6,9450
2,0,6,0,1,1,10,9451
1,0,8,1,0,2,12,9452
2,0,14,1,0,2,19,9453
2,0,9,2,0,0,13,9454
0,0,12,0,0,5,17,9455
1,0,3,2,1,0,7,9456
0,0,10,2,0,4,16,9457
0,0,2,1,1,0,4,9458
2,0,9,0,0,2,13,9460
2,0,6,0,0,3,11,9463
1,0,5,0,0,1,7,9465
3,0,13,0,0,5,21,9466
2,0,8,1,0,3,14,9467
1,1,6,2,0,4,14,9468
0,0,6,2,0,4,12,9469
4,0,7,1,0,7,19,9470
0,0,12,0,0,4,16,9471
4,0,7,1,0,7,19,9472
0,0,4,1,0,1,6,9474
2,0,9,2,0,0,13,9480
2,0,6,4,1,8,21,9481
2,0,9,2,0,0,13,9482
5,3,7,0,1,10,26,9484
0,0,13,0,0,4,17,9485
2,0,9,2,0,0,13,9486
2,0,6,1,0,1,10,9488
0,0,10,0,0,2,12,9489
2,0,9,2,0,0,13,9490
1,0,5,2,1,2,11,9491
1,1,6,0,1,1,10,9492
0,0,2,1,0,0,3,9493
1,1,1,1,0,0,4,9495
5,0,10,2,1,11,29,9496
1,0,9,0,1,4,15,9499
2,0,10,1,0,4,17,9500
1,0,9,0,1,4,15,9501
2,0,9,1,0,7,19,9502
2,1,6,0,0,5,14,9503
2,0,5,1,0,5,13,9504
5,0,10,1,0,2,18,9505
2,0,4,4,2,6,18,9507
0,0,4,0,0,0,4,9508
1,0,4,1,0,2,8,9509
2,1,6,1,1,2,13,9510
5,0,7,2,1,4,19,9511
7,1,6,2,4,6,26,9513
0,0,12,0,0,0,12,9519
1,1,5,1,0,3,11,9520
3,0,9,4,1,4,21,9522
2,0,13,1,0,1,17,9524
0,0,10,2,0,1,13,9525
1,0,6,2,0,2,11,9526
2,0,8,2,0,3,15,9529
1,0,9,3,0,3,16,9531
0,0,3,2,1,1,7,9533
3,1,6,3,2,8,23,9537
4,2,6,3,0,6,21,9538
1,0,9,3,0,3,16,9539
2,0,8,2,0,3,15,9540
3,0,7,3,2,1,16,9541
1,1,12,1,0,3,18,9542
1,0,7,1,0,4,13,9547
4,0,8,2,1,8,23,9548
1,0,8,1,0,1,11,9550
3,4,5,1,1,5,19,9551
0,0,13,2,0,2,17,9552
3,1,7,3,3,6,23,9553
3,0,3,0,2,4,12,9554
0,2,12,0,0,4,18,9555
0,0,6,1,0,2,9,9556
2,0,8,2,0,2,14,9557
2,0,3,0,0,1,6,9559
1,1,3,0,0,1,6,9562
6,0,2,1,0,6,15,9563
1,0,1,1,0,1,4,9564
0,0,7,0,0,0,7,9565
1,1,6,1,1,3,13,9566
1,0,1,1,0,1,4,9567
0,0,6,3,4,4,17,9568
0,0,3,0,0,1,4,9569
2,0,10,1,3,7,23,9571
3,0,3,0,2,3,11,9572
1,0,4,1,0,0,6,9574
1,0,2,1,0,0,4,9575
2,0,6,1,0,3,12,9576
2,1,3,1,1,3,11,9577
1,2,4,1,1,2,11,9579
1,0,9,2,0,5,17,9580
0,0,14,0,0,2,16,9581
1,0,4,1,0,2,8,9582
2,0,10,1,0,1,14,9583
0,0,11,0,2,10,23,9585
4,2,5,0,0,3,14,9586
3,1,1,0,0,1,6,9589
4,2,2,1,4,2,15,9590
3,1,3,0,0,1,8,9591
2,0,2,1,1,2,8,9592
0,0,5,1,0,1,7,9593
1,0,1,1,0,0,3,9594
3,2,6,1,0,3,15,9595
1,1,2,0,0,2,6,9596
2,0,8,2,0,2,14,9597
4,2,7,2,4,8,27,9598
1,1,3,0,0,2,7,9600
0,0,17,1,0,1,19,9602
1,1,2,0,1,0,5,9603
0,0,1,0,0,0,1,9605
2,1,3,0,0,4,10,9606
4,3,6,1,3,2,19,9607
0,0,8,1,1,3,13,9608
0,0,9,0,0,4,13,9609
2,0,4,0,0,3,9,9610
1,0,12,1,0,4,18,9611
1,0,10,1,0,8,20,9612
0,0,13,0,0,1,14,9613
1,0,12,0,0,5,18,9616
3,2,6,3,0,7,21,9617
4,2,3,0,2,5,16,9618
1,0,5,1,0,2,9,9619
2,0,6,0,0,4,12,9620
0,0,21,0,0,1,22,9625
0,0,12,1,0,7,20,9627
6,0,6,2,1,2,17,9629
1,0,14,1,0,6,22,9632
1,0,12,0,0,6,19,9634
1,0,11,1,0,2,15,9636
0,0,13,2,1,4,20,9638
0,0,7,1,0,3,11,9639
2,0,8,0,0,8,18,9640
1,0,14,1,0,8,24,9642
0,0,8,1,0,4,13,9643
2,0,11,0,0,2,15,9644
1,0,13,1,0,2,17,9645
0,0,4,1,0,3,8,9646
1,0,14,0,1,3,19,9650
2,0,15,0,0,5,22,9651
1,0,9,1,0,1,12,9652
0,0,6,0,0,4,10,9653
0,0,6,3,1,8,18,9654
2,0,5,1,0,4,12,9655
1,1,1,1,0,1,5,9656
1,0,12,0,0,5,18,9657
4,4,3,0,1,4,16,9659
0,0,2,0,1,1,4,9660
2,1,3,2,0,4,12,9661
0,0,5,1,1,1,8,9663
1,1,3,1,0,0,6,9664
2,0,6,1,1,5,15,9665
2,1,7,1,0,2,13,9666
2,0,11,2,1,7,23,9667
1,0,13,0,0,8,22,9669
1,0,6,1,0,1,9,9670
4,1,8,1,1,3,18,9672
1,0,11,0,0,10,22,9673
1,1,7,1,0,2,12,9674
2,0,5,1,1,1,10,9675
4,4,8,1,2,7,26,9678
2,0,3,0,0,4,9,9680
3,0,5,1,1,1,11,9681
0,0,5,1,2,4,12,9683
4,1,7,1,2,8,23,9684
0,0,7,1,0,2,10,9686
1,0,9,2,0,3,15,9687
1,0,9,1,0,4,15,9688
4,1,7,4,1,10,27,9690
2,1,9,1,1,5,19,9691
1,0,10,2,1,5,19,9695
1,0,1,0,1,0,3,9697
1,0,8,1,0,2,12,9698
3,0,13,1,1,1,19,9699
1,2,3,0,0,3,9,9701
0,0,8,0,0,2,10,9702
3,1,2,0,1,3,10,9703
1,1,2,0,0,2,6,9704
1,0,10,0,1,3,15,9705
4,2,6,1,2,7,22,9706
1,1,7,3,1,4,17,9707
3,0,7,0,0,3,13,9708
3,0,4,2,1,5,15,9709
4,3,5,0,0,3,15,9710
3,1,2,2,0,6,14,9712
1,0,3,0,0,0,4,9714
3,1,8,3,0,7,22,9715
4,3,11,0,0,5,23,9716
2,0,11,2,0,5,20,9717
4,3,11,0,0,5,23,9718
2,2,4,2,0,2,12,9719
1,0,6,1,0,4,12,9722
2,0,11,1,1,4,19,9723
4,3,6,1,5,6,25,9724
2,0,11,2,1,2,18,9728
5,0,9,2,1,5,22,9729
2,0,6,0,0,3,11,9730
4,3,11,0,0,5,23,9731
3,0,6,3,4,3,19,9732
7,4,6,3,2,8,30,9733
3,2,12,1,0,5,23,9734
2,2,10,2,1,4,21,9736
3,2,12,0,0,5,22,9737
0,0,4,1,0,2,7,9738
4,3,11,0,0,5,23,9739
2,2,3,1,1,2,11,9741
4,3,11,0,0,5,23,9744
3,0,6,1,0,5,15,9745
4,4,13,0,0,5,26,9746
2,2,9,0,1,7,21,9749
5,4,12,0,0,6,27,9750
4,3,11,0,0,5,23,9752
4,3,11,0,0,5,23,9753
4,3,11,0,0,5,23,9754
3,0,13,0,0,7,23,9755
2,1,4,2,0,2,11,9756
0,0,2,2,0,0,4,9757
2,1,14,1,0,2,20,9759
3,1,1,0,0,0,5,9760
0,0,17,0,0,0,17,9761
2,2,3,0,2,2,11,9762
2,0,9,1,0,6,18,9763
8,1,7,2,0,7,25,9764
3,0,8,5,0,5,21,9765
1,0,4,0,1,4,10,9766
5,3,4,1,1,8,22,9769
1,0,5,1,0,2,9,9770
1,0,6,2,0,2,11,9771
2,0,7,2,0,8,19,9772
1,0,4,1,0,2,8,9774
1,0,9,0,0,5,15,9775
4,2,7,0,1,10,24,9776
2,0,10,2,0,4,18,9778
1,0,6,0,0,2,9,9779
4,2,5,1,1,4,17,9780
4,2,8,1,2,7,24,9782
1,0,6,0,0,2,9,9783
1,1,1,0,0,1,4,9785
3,2,6,1,3,4,19,9787
2,0,9,1,0,6,18,9788
2,0,8,0,0,2,12,9790
2,1,3,0,0,3,9,9791
2,0,9,1,0,6,18,9794
1,0,6,2,0,2,11,9795
6,1,9,1,0,6,23,9796
2,0,9,1,0,6,18,9797
2,0,9,1,0,6,18,9800
1,0,5,1,0,2,9,9801
1,0,5,1,0,2,9,9806
3,0,7,2,1,4,17,9808
3,0,7,0,0,6,16,9810
3,1,4,3,1,3,15,9812
0,0,12,0,0,8,20,9813
2,2,10,2,1,4,21,9815
2,1,14,0,1,4,22,9816
1,1,2,2,1,1,8,9818
2,0,3,1,0,3,9,9819
4,2,5,1,0,9,21,9820
3,3,7,2,0,6,21,9822
2,0,9,0,1,3,15,9823
3,0,6,0,1,1,11,9826
0,0,3,0,0,0,3,9828
0,0,7,0,0,2,9,9829
6,6,4,1,0,5,22,9830
2,2,5,3,0,8,20,9831
2,2,5,2,1,2,14,9832
1,0,12,0,0,3,16,9833
0,0,7,1,0,3,11,9834
3,0,5,1,0,3,12,9835
6,2,3,3,1,8,23,9836
2,1,2,0,1,3,9,9837
1,0,8,3,0,1,13,9838
4,1,8,0,1,8,22,9841
2,1,6,2,0,4,15,9842
5,4,3,1,4,8,25,9846
3,3,5,1,1,12,25,9849
2,0,7,2,0,1,12,9850
6,1,8,2,0,9,26,9853
3,0,8,0,0,4,15,9854
4,6,3,2,1,5,21,9857
4,1,5,1,2,7,20,9858
5,0,4,4,2,5,20,9859
0,0,12,0,0,2,14,9860
1,0,1,0,1,0,3,9861
5,1,3,2,0,4,15,9862
2,0,3,2,1,1,9,9864
4,1,2,0,2,3,12,9865
5,4,6,1,0,4,20,9866
6,0,9,1,2,7,25,9868
1,0,2,0,1,0,4,9869
1,0,3,0,0,1,5,9870
2,0,6,3,1,6,18,9872
1,0,3,1,3,3,11,9873
1,0,3,1,0,4,9,9874
1,0,2,0,0,0,3,9875
5,1,6,0,3,6,21,9877
0,0,5,0,0,1,6,9878
1,0,1,1,0,0,3,9880
6,2,3,2,0,4,17,9881
0,0,3,1,1,0,5,9883
2,1,5,2,1,6,17,9884
2,0,5,4,2,2,15,9885
3,0,7,3,1,6,20,9886
3,2,6,2,1,7,21,9887
5,4,11,3,0,3,26,9888
4,1,5,1,0,4,15,9889
5,1,6,3,2,8,25,9890
4,1,3,0,1,3,12,9894
3,1,9,3,0,5,21,9896
1,0,3,0,1,3,8,9897
3,1,5,0,1,3,13,9898
3,1,6,1,0,1,12,9901
1,0,4,0,0,0,5,9905
2,1,4,1,0,2,10,9906
4,2,4,0,1,4,15,9907
2,2,3,1,0,5,13,9909
3,1,4,1,0,3,12,9910
3,1,7,2,1,3,17,9911
2,1,4,5,1,4,17,9912
0,0,10,0,0,4,14,9915
5,1,3,3,2,4,18,9916
5,2,6,0,2,8,23,9918
0,0,1,0,1,1,3,9919
2,2,2,1,0,1,8,9920
2,0,3,1,1,2,9,9921
4,1,7,1,1,4,18,9923
5,0,4,0,1,3,13,9925
5,2,5,1,1,2,16,9930
0,0,6,0,0,1,7,9931
1,0,5,1,0,5,12,9932
2,0,7,1,0,2,12,9933
3,2,11,6,2,7,31,9934
1,0,3,1,0,4,9,9935
2,2,2,0,0,2,8,9937
2,1,4,1,0,2,10,9938
3,3,7,4,0,4,21,9940
2,3,5,1,1,5,17,9941
3,2,6,3,3,6,23,9942
6,1,3,0,1,7,18,9943
2,1,6,5,3,1,18,9944
2,1,2,1,3,3,12,9945
1,0,6,0,0,4,11,9946
2,1,7,2,1,3,16,9948
2,1,10,1,2,10,26,9949
2,1,4,1,1,2,11,9950
10,2,6,0,0,7,25,9952
0,0,6,0,0,2,8,9953
1,0,3,2,0,2,8,9955
1,1,1,1,1,0,5,9958
4,3,6,1,1,2,17,9960
1,1,13,0,0,5,20,9961
1,0,13,0,0,5,19,9963
0,0,9,0,0,2,11,9965
1,2,1,1,0,1,6,9967
4,0,3,2,0,3,12,9971
2,0,5,1,0,1,9,9972
4,0,9,0,0,3,16,9973
2,2,2,1,1,2,10,9974
2,0,7,1,0,6,16,9976
3,0,5,1,1,4,14,9978
0,0,9,0,0,2,11,9979
4,0,9,0,0,3,16,9980
0,0,3,0,0,0,3,9982
3,3,6,1,1,7,21,9983
2,0,6,0,0,3,11,9984
4,0,6,1,0,5,16,9985
0,0,3,1,0,0,4,9986
0,1,4,0,0,2,7,9987
5,0,10,1,1,5,22,9988
4,2,3,0,0,5,14,9989
0,0,3,1,0,0,4,9990
2,1,11,1,0,4,19,9991
5,2,4,0,2,4,17,9992
1,2,9,2,1,6,21,9994
4,3,5,0,1,3,16,9995
3,2,9,1,2,6,23,9998
2,1,7,1,0,4,15,10000
1,1,7,3,0,0,12,10001
2,1,1,0,0,2,6,10003
1,1,12,0,0,5,19,10004
0,0,1,0,0,3,4,10005
1,1,1,0,0,1,4,10006
1,1,6,1,0,3,12,10008
2,3,12,0,0,6,23,10009
1,0,13,0,0,2,16,10010
7,2,10,9,4,1,33,10011
3,2,11,0,1,11,28,10012
1,0,5,0,0,4,10,10013
3,0,6,0,0,2,11,10014
2,0,13,1,0,3,19,10016
0,0,7,0,0,2,9,10017
1,0,2,1,0,0,4,10018
3,0,4,0,1,1,9,10020
5,1,7,1,2,10,26,10021
2,1,4,0,0,1,8,10023
0,0,15,1,0,6,22,10025
2,2,4,1,0,1,10,10027
4,1,12,0,0,8,25,10028
2,1,8,0,0,2,13,10029
0,0,10,1,0,3,14,10030
1,0,6,1,0,4,12,10031
3,1,3,0,0,3,10,10032
1,0,15,0,0,3,19,10034
0,0,6,0,0,2,8,10035
0,0,2,1,0,0,3,10036
0,3,9,0,1,8,21,10037
1,0,7,3,0,8,19,10038
1,1,5,1,0,1,9,10039
1,0,9,0,0,2,12,10040
7,3,9,2,0,8,29,10041
2,1,5,0,0,1,9,10042
0,0,9,1,0,1,11,10044
0,0,12,0,0,1,13,10045
3,0,3,1,1,1,9,10047
1,1,2,2,0,1,7,10048
2,1,9,1,1,8,22,10049
1,0,2,1,1,0,5,10050
2,1,8,3,2,6,22,10052
3,0,5,1,2,0,11,10054
4,1,3,0,3,6,17,10055
2,1,7,2,2,6,20,10056
5,0,6,0,5,5,21,10057
0,0,11,1,0,1,13,10058
4,1,11,1,0,4,21,10059
4,1,9,1,0,5,20,10060
1,0,10,1,0,2,14,10061
1,0,11,0,0,3,15,10064
2,0,11,0,0,2,15,10066
1,0,11,0,0,3,15,10067
1,0,11,0,0,3,15,10069
4,2,10,2,2,2,22,10070
1,0,11,0,0,2,14,10071
2,2,7,1,0,5,17,10072
1,0,11,0,0,3,15,10073
1,0,11,0,0,2,14,10074
1,0,5,1,0,1,8,10075
1,0,9,1,0,2,13,10076
2,0,4,1,0,1,8,10077
6,0,12,1,0,5,24,10079
1,0,12,0,0,2,15,10080
1,0,11,0,0,3,15,10081
1,0,11,0,0,3,15,10082
1,0,4,0,0,1,6,10083
1,0,11,0,0,3,15,10084
0,0,7,0,0,2,9,10085
4,1,8,1,0,4,18,10087
1,0,14,0,0,3,18,10088
0,1,9,0,0,1,11,10089
0,0,8,0,0,1,9,10090
0,0,4,1,0,1,6,10091
0,0,6,0,0,2,8,10092
1,0,9,1,0,2,13,10093
4,1,11,1,0,4,21,10098
0,0,6,0,0,2,8,10099
2,0,5,2,0,6,15,10100
2,1,2,0,2,2,9,10101
1,0,2,0,0,2,5,10102
1,0,11,0,0,3,15,10105
1,0,11,0,0,3,15,10106
1,0,5,1,0,1,8,10107
2,1,10,2,1,7,23,10109
0,0,6,1,0,4,11,10110
2,0,7,3,1,7,20,10111
1,0,2,0,0,1,4,10112
0,0,8,1,0,4,13,10113
2,1,6,3,2,4,18,10114
3,1,10,0,1,5,20,10115
4,1,7,3,0,4,19,10116
0,0,13,1,0,2,16,10117
1,0,6,2,0,1,10,10118
2,0,8,4,0,8,22,10119
0,0,9,0,0,1,10,10120
2,0,8,4,0,8,22,10121
0,0,6,1,0,4,11,10124
0,0,3,2,0,6,11,10125
0,0,5,3,0,1,9,10126
1,0,9,3,0,9,22,10127
4,0,10,0,0,4,18,10129
0,0,7,0,0,1,8,10130
3,1,5,1,1,3,14,10132
4,0,4,2,0,3,13,10136
0,0,8,0,0,1,9,10137
0,0,8,0,0,1,9,10138
4,0,7,1,1,3,16,10139
0,0,10,1,0,2,13,10140
1,0,11,1,0,4,17,10141
2,0,13,1,0,8,24,10142
1,0,7,0,0,1,9,10143
1,1,6,4,0,8,20,10144
5,1,7,2,1,7,23,10146
0,0,7,0,0,4,11,10147
0,0,6,0,0,2,8,10149
2,0,3,3,0,3,11,10150
4,0,7,1,1,3,16,10151
3,1,9,0,1,5,19,10152
2,0,7,0,0,4,13,10153
0,0,6,1,0,4,11,10156
3,2,8,2,0,6,21,10157
2,0,9,1,0,6,18,10159
0,0,4,1,1,2,8,10163
0,0,6,1,0,1,8,10164
3,1,11,4,1,5,25,10168
0,0,12,1,0,2,15,10169
1,0,10,1,0,3,15,10171
2,0,10,1,0,3,16,10172
1,0,9,1,1,2,14,10173
1,0,9,3,0,3,16,10174
0,0,9,2,1,3,15,10175
1,0,8,3,0,3,15,10176
3,1,7,3,0,2,16,10177
1,0,10,1,1,2,15,10179
5,5,9,0,0,5,24,10182
1,0,4,2,1,3,11,10183
4,0,8,3,2,5,22,10184
1,0,6,2,0,2,11,10186
1,0,9,3,0,4,17,10187
3,1,5,4,0,10,23,10189
0,0,8,1,0,1,10,10191
0,0,7,1,0,1,9,10192
4,4,5,2,1,11,27,10193
1,0,8,1,0,3,13,10194
3,0,10,1,0,2,16,10195
3,1,4,1,0,3,12,10197
0,1,5,2,0,1,9,10198
2,0,8,3,0,9,22,10199
2,0,10,4,0,3,19,10201
0,0,10,1,0,3,14,10202
5,3,11,0,0,12,31,10203
0,0,7,1,0,1,9,10204
1,0,11,2,0,3,17,10206
2,0,10,3,1,0,16,10207
2,0,9,0,1,5,17,10208
0,0,12,0,2,7,21,10209
1,1,9,0,0,2,13,10210
1,0,8,3,0,10,22,10212
2,0,10,2,0,5,19,10213
2,0,6,1,0,5,14,10214
1,0,10,1,0,6,18,10215
2,0,11,1,0,5,19,10217
0,0,16,0,0,4,20,10218
2,0,7,2,0,9,20,10220
0,0,9,3,0,11,23,10222
0,0,10,3,0,10,23,10223
1,0,9,0,0,1,11,10224
2,0,8,1,0,5,16,10226
0,0,7,1,0,4,12,10229
0,0,16,0,0,4,20,10231
3,1,8,0,5,8,25,10234
1,1,7,1,0,6,16,10236
4,1,10,2,3,5,25,10237
0,0,4,0,0,0,4,10239
3,0,14,0,0,2,19,10241
0,0,8,0,0,1,9,10243
3,0,5,0,1,6,15,10244
0,1,1,0,0,3,5,10245
2,0,4,2,4,3,15,10246
0,0,10,3,0,10,23,10247
0,1,11,0,0,5,17,10249
7,2,6,0,1,7,23,10250
1,1,9,1,0,6,18,10251
3,0,7,2,1,3,16,10252
2,0,2,0,0,3,7,10253
2,3,6,1,1,6,19,10255
3,0,6,0,1,3,13,10256
2,0,7,0,0,3,12,10258
0,0,10,1,0,4,15,10259
1,1,5,0,0,2,9,10260
3,0,6,2,3,5,19,10263
2,0,5,0,1,2,10,10264
2,0,6,0,0,5,13,10265
4,1,8,3,0,10,26,10268
3,1,8,3,1,4,20,10269
1,2,11,0,0,4,18,10270
3,1,4,0,0,3,11,10272
3,4,8,1,1,11,28,10273
1,0,3,0,0,3,7,10274
2,1,6,1,0,6,16,10275
1,1,4,0,0,2,8,10276
5,0,4,2,1,7,19,10278
3,0,5,0,0,3,11,10280
2,0,12,0,0,1,15,10283
1,0,4,0,0,4,9,10284
3,1,11,1,2,8,26,10286
7,5,7,1,1,6,27,10287
5,1,8,2,2,5,23,10288
3,1,8,1,1,5,19,10289
2,0,7,1,1,6,17,10290
1,0,5,3,0,6,15,10291
1,1,2,0,0,0,4,10293
5,7,5,2,0,7,26,10294
0,0,3,0,0,0,3,10295
2,0,8,3,0,5,18,10296
6,2,5,1,1,5,20,10297
0,0,15,0,0,0,15,10299
3,2,4,2,0,3,14,10301
0,1,6,1,0,6,14,10302
3,2,5,3,1,3,17,10303
2,0,8,1,0,1,12,10304
1,0,10,0,0,2,13,10305
1,3,1,2,0,2,9,10306
1,0,3,2,0,2,8,10307
1,0,4,0,0,1,6,10308
1,1,15,2,0,3,22,10310
1,0,3,1,1,5,11,10313
4,0,15,0,0,4,23,10314
2,0,3,2,1,2,10,10315
2,0,2,1,1,1,7,10316
3,1,8,2,0,4,18,10317
4,5,4,0,1,3,17,10318
4,1,10,0,1,7,23,10320
2,0,2,1,1,2,8,10321
2,0,9,2,3,5,21,10322
3,1,7,1,1,6,19,10323
6,4,5,1,3,6,25,10325
1,1,4,0,0,1,7,10327
0,0,3,0,0,0,3,10329
1,0,4,1,0,3,9,10330
5,0,6,1,0,9,21,10331
5,1,8,3,1,9,27,10332
1,2,6,0,0,2,11,10333
1,0,4,2,0,1,8,10334
4,2,5,2,1,5,19,10335
1,0,20,2,0,3,26,10336
1,0,6,2,1,5,15,10337
2,2,5,3,0,4,16,10338
6,4,7,1,0,12,30,10339
2,0,7,5,1,8,23,10340
6,0,6,2,0,10,24,10341
2,0,8,0,1,2,13,10342
3,1,7,3,1,6,21,10344
3,1,11,0,0,2,17,10345
1,1,9,1,0,4,16,10348
4,1,7,2,0,4,18,10349
1,0,14,0,0,2,17,10350
1,1,3,0,2,4,11,10351
0,0,4,0,0,0,4,10352
3,0,6,2,1,8,20,10355
1,0,8,0,0,3,12,10358
4,1,7,2,0,8,22,10359
2,0,10,2,1,3,18,10360
4,0,7,1,0,5,17,10361
2,1,8,1,0,3,15,10364
5,1,10,3,1,6,26,10365
1,0,3,1,0,1,6,10366
2,1,12,0,1,1,17,10367
4,2,7,1,0,5,19,10368
4,0,8,2,1,4,19,10369
3,0,6,1,0,5,15,10371
3,1,5,0,2,6,17,10372
1,1,1,1,1,2,7,10374
2,1,12,0,1,1,17,10375
1,1,9,1,0,4,16,10376
5,2,4,1,2,6,20,10377
5,2,7,0,2,7,23,10378
4,3,7,2,1,5,22,10379
1,0,8,0,0,2,11,10380
1,1,9,1,0,4,16,10381
0,0,8,0,0,4,12,10382
4,0,7,0,0,5,16,10383
0,0,8,1,1,5,15,10384
7,4,7,1,1,4,24,10385
5,4,7,2,3,7,28,10387
3,2,2,0,0,1,8,10390
0,0,7,0,0,0,7,10392
2,2,7,1,0,8,20,10393
2,0,7,0,0,2,11,10394
7,1,5,2,5,6,26,10395
2,0,2,0,1,4,9,10396
3,1,3,4,0,5,16,10398
0,0,9,1,0,1,11,10399
0,0,13,2,0,5,20,10401
1,0,10,1,0,2,14,10402
4,2,8,3,0,7,24,10405
0,0,4,0,1,3,8,10406
1,0,1,2,0,2,6,10407
3,3,6,0,1,4,17,10409
0,0,9,1,0,3,13,10410
2,0,10,0,0,5,17,10411
2,1,5,2,0,8,18,10412
2,1,6,2,0,5,16,10413
2,0,4,3,1,9,19,10414
1,1,6,1,1,2,12,10415
1,0,13,1,0,2,17,10416
1,0,6,0,0,7,14,10418
0,0,10,0,0,2,12,10419
3,1,7,0,0,8,19,10420
1,0,3,2,0,2,8,10421
6,4,5,1,2,10,28,10422
1,0,1,0,0,1,3,10423
7,2,7,0,3,9,28,10424
1,0,8,3,0,5,17,10426
3,1,8,0,1,2,15,10427
1,1,9,0,1,4,16,10428
1,0,4,0,0,3,8,10429
5,2,5,1,1,8,22,10430
0,1,8,0,0,0,9,10431
4,5,8,4,1,6,28,10432
3,0,3,2,0,2,10,10433
1,0,11,1,0,4,17,10434
3,0,6,3,0,1,13,10436
0,0,9,0,0,4,13,10439
4,1,8,2,0,7,22,10441
3,0,7,3,1,6,20,10443
3,0,11,1,0,5,20,10444
2,1,9,2,3,4,21,10445
2,0,10,4,0,3,19,10446
1,0,6,0,0,2,9,10448
4,1,8,0,0,3,16,10449
1,0,7,1,0,3,12,10450
4,1,9,5,0,4,23,10451
4,3,3,1,0,4,15,10455
3,0,10,2,0,2,17,10456
4,0,8,5,1,2,20,10457
1,1,3,1,1,3,10,10458
3,2,3,1,2,6,17,10461
5,1,8,3,0,3,20,10462
6,3,5,0,3,9,26,10464
4,0,5,1,0,3,13,10466
1,0,1,3,0,2,7,10467
2,0,5,1,0,3,11,10468
0,0,7,4,2,7,20,10470
0,0,8,2,0,4,14,10471
3,1,15,1,0,3,23,10472
3,0,3,2,0,3,11,10473
4,3,3,1,1,2,14,10478
2,1,10,1,0,3,17,10479
2,1,2,1,1,0,7,10481
7,2,7,2,1,6,25,10482
2,1,3,1,0,7,14,10483
4,0,10,3,1,4,22,10484
6,2,4,0,0,7,19,10485
2,0,7,1,0,2,12,10486
1,0,8,0,0,3,12,10487
0,0,18,0,0,0,18,10488
0,0,15,1,0,2,18,10489
3,1,8,2,1,6,21,10490
1,1,5,0,0,6,13,10492
0,1,15,0,0,3,19,10496
2,0,12,0,0,3,17,10498
0,0,2,1,0,1,4,10499
2,0,8,1,1,1,13,10500
0,0,15,1,0,2,18,10502
1,0,8,1,0,5,15,10503
2,1,4,0,2,1,10,10505
0,0,11,1,0,1,13,10506
3,1,13,3,0,6,26,10508
3,0,7,0,1,1,12,10511
5,4,1,1,2,3,16,10513
2,0,8,1,1,3,15,10515
3,0,7,1,0,2,13,10516
1,0,7,0,0,3,11,10517
2,1,6,0,2,2,13,10518
2,0,11,1,0,3,17,10519
1,0,7,2,0,2,12,10520
3,0,8,2,0,2,15,10521
2,1,9,0,1,1,14,10522
1,0,4,0,0,2,7,10523
3,1,5,1,1,8,19,10524
2,0,10,1,0,7,20,10525
1,0,5,1,0,1,8,10527
1,0,14,0,0,2,17,10529
1,0,8,0,1,4,14,10533
1,0,7,0,1,1,10,10534
1,0,10,1,0,8,20,10535
0,0,8,0,0,2,10,10536
1,1,11,1,1,6,21,10537
1,0,7,2,0,2,12,10540
1,0,8,0,0,3,12,10541
1,0,8,0,0,3,12,10543
0,0,4,1,0,3,8,10544
0,0,7,0,0,3,10,10545
2,2,3,0,0,3,10,10546
1,0,8,2,0,3,14,10548
1,0,12,1,0,4,18,10550
1,0,6,1,0,2,10,10551
2,0,11,0,0,5,18,10552
1,0,5,0,0,1,7,10553
1,0,9,0,0,1,11,10554
1,0,8,1,0,2,12,10555
3,2,6,2,0,7,20,10557
1,0,7,2,0,8,18,10558
1,0,7,0,0,7,15,10559
1,0,7,0,0,3,11,10560
1,0,6,1,0,2,10,10561
1,0,7,0,0,3,11,10562
1,1,6,3,0,3,14,10563
1,0,4,1,0,0,6,10564
3,3,7,3,1,7,24,10565
1,1,7,1,0,5,15,10566
3,0,12,6,1,6,28,10567
2,0,12,0,0,3,17,10568
1,0,6,1,0,2,10,10570
1,0,5,0,0,1,7,10571
1,0,8,0,0,3,12,10573
3,1,4,1,1,3,13,10574
1,0,7,0,0,3,11,10575
2,0,13,0,0,3,18,10576
1,0,7,1,0,4,13,10578
1,2,8,3,2,7,23,10580
0,1,11,1,1,5,19,10581
2,0,5,1,2,4,14,10582
2,0,13,0,0,3,18,10583
1,0,8,0,0,3,12,10584
4,0,11,0,0,4,19,10585
2,0,6,0,0,1,9,10587
1,2,4,1,2,1,11,10588
3,0,9,2,1,4,19,10589
2,0,14,2,0,6,24,10590
3,0,11,0,0,3,17,10591
2,0,5,0,1,3,11,10592
2,0,5,0,0,0,7,10593
1,0,12,0,0,3,16,10596
5,2,9,3,0,10,29,10598
4,1,7,0,0,5,17,10599
4,0,11,0,0,3,18,10600
1,1,4,1,1,0,8,10601
4,0,11,0,0,4,19,10603
6,5,6,2,1,5,25,10605
2,0,5,0,1,3,11,10606
0,0,10,1,0,2,13,10607
0,0,7,0,0,3,10,10608
1,0,4,1,0,3,9,10609
5,2,7,0,1,8,23,10610
3,0,10,3,0,3,19,10611
2,0,6,0,0,1,9,10612
3,0,8,0,0,1,12,10613
3,0,6,1,0,1,11,10615
3,0,6,1,0,5,15,10616
4,0,10,0,0,2,16,10620
2,0,4,3,0,6,15,10621
3,0,11,0,0,3,17,10622
2,0,5,0,0,1,8,10623
6,0,7,1,0,5,19,10625
5,0,9,5,0,3,22,10626
3,0,10,4,0,3,20,10627
2,0,8,2,0,1,13,10628
2,0,15,1,0,6,24,10629
4,2,7,4,2,7,26,10630
1,0,7,1,0,2,11,10631
4,0,10,0,0,2,16,10632
3,0,7,4,1,10,25,10636
2,1,5,0,1,2,11,10637
2,0,4,0,0,4,10,10640
1,0,14,0,0,1,16,10641
2,1,4,1,1,5,14,10644
4,0,8,1,0,5,18,10647
7,4,3,1,2,4,21,10648
3,0,9,2,2,10,26,10650
1,0,5,2,1,2,11,10651
3,4,4,1,0,4,16,10655
2,1,10,1,0,8,22,10656
3,0,7,2,1,2,15,10657
1,1,4,0,0,2,8,10658
0,0,2,0,0,1,3,10659
6,5,6,1,1,6,25,10660
4,0,7,1,1,15,28,10662
4,0,2,1,1,5,13,10663
3,0,3,1,1,5,13,10665
6,2,2,1,0,3,14,10666
1,0,8,1,0,1,11,10667
7,2,3,0,3,7,22,10669
9,3,3,1,2,6,24,10671
5,0,5,1,3,2,16,10672
1,1,5,0,0,2,9,10673
3,0,5,2,1,2,13,10675
5,0,12,6,1,6,30,10676
1,0,7,1,0,4,13,10677
4,2,6,0,1,5,18,10678
2,1,7,2,2,9,23,10679
2,2,2,0,1,3,10,10680
2,0,11,1,0,7,21,10681
0,0,8,1,0,2,11,10682
3,0,4,4,3,8,22,10684
1,1,5,1,2,4,14,10685
0,0,2,1,0,0,3,10686
1,1,1,0,0,1,4,10687
4,1,9,2,1,7,24,10688
0,0,13,0,0,0,13,10689
5,3,3,1,2,2,16,10690
1,0,7,1,0,2,11,10691
1,0,5,0,0,1,7,10692
6,1,4,1,0,5,17,10693
0,0,14,1,0,0,15,10695
2,0,9,4,1,8,24,10696
3,2,4,1,0,3,13,10698
2,0,10,1,0,2,15,10700
2,1,7,3,0,5,18,10702
4,1,5,3,4,5,22,10704
4,1,12,3,1,4,25,10705
2,2,3,0,0,0,7,10706
3,2,8,4,3,4,24,10707
0,0,2,1,2,1,6,10708
3,2,7,0,0,3,15,10709
3,3,6,2,2,2,18,10710
0,0,4,0,0,4,8,10711
2,0,11,0,0,6,19,10712
0,0,10,0,0,3,13,10715
4,3,7,2,2,8,26,10718
3,1,5,2,1,1,13,10720
4,2,4,1,3,5,19,10721
1,0,4,0,0,1,6,10722
1,0,10,0,1,6,18,10723
1,1,2,3,1,2,10,10724
3,2,5,1,1,5,17,10726
5,1,7,2,2,11,28,10727
2,0,5,1,0,3,11,10729
4,1,7,1,0,9,22,10730
0,0,5,1,1,1,8,10731
0,0,11,1,0,2,14,10732
1,0,3,1,0,1,6,10733
1,1,8,0,1,7,18,10735
1,0,10,0,0,2,13,10736
1,1,8,0,1,7,18,10737
3,0,6,1,1,2,13,10739
1,1,8,0,1,7,18,10741
3,0,12,1,0,3,19,10743
1,1,8,0,1,7,18,10744
1,1,8,0,1,7,18,10745
2,0,13,2,0,10,27,10746
4,1,11,1,1,5,23,10747
1,0,6,1,0,1,9,10748
1,1,8,0,1,7,18,10749
1,1,8,0,1,7,18,10750
4,0,14,1,0,1,20,10751
1,1,8,0,1,7,18,10752
1,1,8,0,1,7,18,10753
0,0,5,0,1,3,9,10754
1,0,16,0,0,1,18,10755
2,0,7,2,0,2,13,10759
1,1,8,0,1,7,18,10760
3,0,7,2,0,13,25,10763
1,1,8,0,1,7,18,10764
4,1,11,1,1,5,23,10765
1,1,8,0,1,7,18,10766
1,1,8,0,1,7,18,10767
2,0,6,0,0,0,8,10768
2,0,8,0,0,4,14,10769
4,1,11,1,1,5,23,10770
0,0,5,0,1,3,9,10771
1,1,8,0,1,7,18,10772
1,0,7,0,1,3,12,10774
1,1,8,0,1,7,18,10775
0,0,5,0,1,3,9,10776
1,1,8,0,1,7,18,10777
1,1,8,0,1,7,18,10779
1,1,8,0,1,7,18,10780
1,1,8,0,1,7,18,10782
2,0,3,1,1,4,11,10783
1,1,8,0,1,7,18,10784
2,0,7,0,2,5,16,10785
3,1,8,3,1,6,22,10786
3,2,6,1,1,3,16,10787
5,1,7,0,0,8,21,10788
4,0,4,1,1,7,17,10789
2,0,11,0,0,2,15,10790
2,2,6,1,0,3,14,10793
1,2,4,0,0,3,10,10794
2,3,4,0,1,0,10,10795
1,0,9,0,0,2,12,10798
2,0,6,2,0,1,11,10799
1,0,7,0,0,2,10,10800
2,0,2,1,1,2,8,10802
3,4,4,2,1,2,16,10803
1,0,2,0,0,0,3,10805
1,0,3,2,0,2,8,10808
2,0,3,0,1,1,7,10809
1,0,2,2,0,0,5,10810
1,2,1,1,0,0,5,10811
1,2,2,0,0,0,5,10812
4,3,5,1,2,5,20,10813
2,0,0,3,1,3,9,10814
1,0,6,1,0,2,10,10815
0,0,1,1,0,0,2,10817
3,2,4,6,1,8,24,10818
5,2,2,3,1,2,15,10819
1,0,8,0,0,2,11,10821
3,0,4,0,1,3,11,10822
2,1,3,0,1,0,7,10823
3,0,4,2,0,2,11,10824
1,0,5,0,0,2,8,10825
1,1,2,1,0,2,7,10826
2,2,0,0,1,2,7,10827
5,4,8,0,0,3,20,10829
1,2,2,0,0,2,7,10830
3,1,4,1,2,9,20,10831
2,0,7,1,0,2,12,10832
3,0,6,1,1,2,13,10833
1,0,7,0,0,2,10,10834
3,1,9,1,0,3,17,10835
5,0,5,2,1,2,15,10837
0,0,6,1,0,1,8,10839
1,0,7,1,0,3,12,10840
0,0,1,0,1,0,2,10841
1,0,9,1,0,4,15,10842
0,0,2,0,0,0,2,10843
0,0,20,0,0,5,25,10844
4,1,6,0,1,4,16,10846
2,0,9,3,0,7,21,10847
2,1,2,3,2,2,12,10848
2,1,6,1,2,5,17,10849
0,0,11,0,0,3,14,10850
1,0,11,3,1,2,18,10851
3,0,8,0,0,2,13,10852
0,0,7,1,0,3,11,10853
1,0,10,1,0,6,18,10854
1,0,6,0,0,2,9,10855
4,0,4,3,0,2,13,10859
3,1,3,0,2,3,12,10860
3,0,9,1,0,7,20,10862
3,1,12,0,0,4,20,10863
4,1,5,2,3,11,26,10864
0,0,13,0,0,3,16,10866
0,0,12,1,0,2,15,10867
2,0,4,2,0,3,11,10869
0,0,7,4,2,7,20,10870
0,0,7,1,0,4,12,10871
1,0,9,4,0,5,19,10872
1,0,7,2,0,2,12,10873
